"date","geography","geography code","Rural Urban","Variable: All usual residents; measures: Value","Variable: Males; measures: Value","Variable: Females; measures: Value","Variable: Lives in a household; measures: Value","Variable: Lives in a communal establishment; measures: Value","Variable: Schoolchild or full-time student aged 4 and over at their non term-time address; measures: Value","Variable: Area (Hectares); measures: Value","Variable: Density (number of persons per hectare); measures: Value"
"2011","AL1  1","AL1  1","Total",5453,2715,2738,5408,45,75,225.63,24.2
"2011","AL1  2","AL1  2","Total",6523,3183,3340,6418,105,77,286.59,22.8
"2011","AL1  3","AL1  3","Total",4179,2121,2058,4100,79,46,97.12,43.0
"2011","AL1  4","AL1  4","Total",9799,4845,4954,9765,34,285,244.75,40.0
"2011","AL1  5","AL1  5","Total",10226,5129,5097,10211,15,133,200.93,50.9
"2011","AL10 0","AL10 0","Total",9935,5039,4896,9855,80,60,243.62,40.8
"2011","AL10 8","AL10 8","Total",10998,5648,5350,10833,165,122,216.76,50.7
"2011","AL10 9","AL10 9","Total",14967,7640,7327,12219,2748,185,1563.16,9.6
"2011","AL2  1","AL2  1","Total",9507,4661,4846,9440,67,107,512.98,18.5
"2011","AL2  2","AL2  2","Total",6130,3058,3072,6034,96,76,937.54,6.5
"2011","AL2  3","AL2  3","Total",7967,3877,4090,7863,104,168,2284.36,3.5
"2011","AL3  4","AL3  4","Total",5565,2763,2802,5500,65,131,302.42,18.4
"2011","AL3  5","AL3  5","Total",8831,4200,4631,8604,227,173,228.02,38.7
"2011","AL3  6","AL3  6","Total",4281,2070,2211,4271,10,81,1400.81,3.1
"2011","AL3  7","AL3  7","Total",5344,2582,2762,5284,60,85,1908.57,2.8
"2011","AL3  8","AL3  8","Total",4441,2215,2226,4402,39,74,2963.95,1.5
"2011","AL4  0","AL4  0","Total",9308,4717,4591,9215,93,168,1199.86,7.8
"2011","AL4  8","AL4  8","Total",6509,3108,3401,6504,5,178,2581.33,2.5
"2011","AL4  9","AL4  9","Total",11451,5563,5888,11383,68,255,1518.78,7.5
"2011","AL5  1","AL5  1","Total",6090,3016,3074,6074,16,187,245.11,24.8
"2011","AL5  2","AL5  2","Total",4676,2270,2406,4622,54,248,445.18,10.5
"2011","AL5  3","AL5  3","Total",4659,2272,2387,4631,28,174,1068.25,4.4
"2011","AL5  4","AL5  4","Total",6450,3121,3329,6101,349,163,286.23,22.5
"2011","AL5  5","AL5  5","Total",8365,4094,4271,8279,86,180,265.47,31.5
"2011","AL6  0","AL6  0","Total",6434,3155,3279,6416,18,204,1560.36,4.1
"2011","AL6  9","AL6  9","Total",4788,2340,2448,4688,100,113,1750.96,2.7
"2011","AL7  1","AL7  1","Total",5761,2789,2972,5761,0,64,260.12,22.1
"2011","AL7  2","AL7  2","Total",7395,3715,3680,7342,53,102,229.93,32.2
"2011","AL7  3","AL7  3","Total",10114,4842,5272,10008,106,67,244.47,41.4
"2011","AL7  4","AL7  4","Total",10620,5156,5464,10563,57,122,328.64,32.3
"2011","AL8  6","AL8  6","Total",5869,2750,3119,5869,0,106,262.73,22.3
"2011","AL8  7","AL8  7","Total",7383,3495,3888,7316,67,131,601.94,12.3
"2011","AL9  5","AL9  5","Total",2085,1014,1071,2054,31,26,1347.81,1.5
"2011","AL9  6","AL9  6","Total",1427,610,817,1217,210,46,1811.33,0.8
"2011","AL9  7","AL9  7","Total",6897,3328,3569,6803,94,162,1419.24,4.9
"2011","B1   1","B1   1","Total",4099,2340,1759,3402,697,46,32.78,125.0
"2011","B1   2","B1   2","Total",2897,1584,1313,2693,204,19,49.12,59.0
"2011","B1   3","B1   3","Total",993,581,412,993,0,3,19.54,50.8
"2011","B10  0","B10  0","Total",8206,4236,3970,8187,19,39,143.13,57.3
"2011","B10  9","B10  9","Total",17702,8800,8902,17691,11,99,163.87,108.0
"2011","B11  1","B11  1","Total",11688,5989,5699,11625,63,70,157.80,74.1
"2011","B11  2","B11  2","Total",3479,1748,1731,3469,10,16,138.39,25.1
"2011","B11  3","B11  3","Total",17242,8608,8634,17226,16,119,225.79,76.4
"2011","B11  4","B11  4","Total",12295,6210,6085,12263,32,107,106.67,115.3
"2011","B12  0","B12  0","Total",4129,2227,1902,4072,57,12,103.70,39.8
"2011","B12  8","B12  8","Total",8748,4443,4305,8696,52,75,101.90,85.8
"2011","B12  9","B12  9","Total",7878,3975,3903,7771,107,77,97.28,81.0
"2011","B13  0","B13  0","Total",13458,6465,6993,13406,52,134,352.53,38.2
"2011","B13  8","B13  8","Total",7678,4079,3599,7527,151,98,286.34,26.8
"2011","B13  9","B13  9","Total",15681,7957,7724,15390,291,186,276.45,56.7
"2011","B14  4","B14  4","Total",12710,6206,6504,12597,113,65,279.02,45.6
"2011","B14  5","B14  5","Total",10926,5301,5625,10827,99,41,234.65,46.6
"2011","B14  6","B14  6","Total",12143,5853,6290,12080,63,143,264.43,45.9
"2011","B14  7","B14  7","Total",7634,3740,3894,7587,47,112,131.46,58.1
"2011","B15  1","B15  1","Total",2582,1448,1134,1966,616,38,55.00,46.9
"2011","B15  2","B15  2","Total",9675,4794,4881,7003,2672,147,296.24,32.7
"2011","B15  3","B15  3","Total",5964,2877,3087,4548,1416,141,282.80,21.1
"2011","B16  0","B16  0","Total",10022,5104,4918,9992,30,74,187.13,53.6
"2011","B16  8","B16  8","Total",6754,3619,3135,6720,34,38,88.92,76.0
"2011","B16  9","B16  9","Total",6994,3728,3266,6868,126,63,114.05,61.3
"2011","B17  0","B17  0","Total",8835,4285,4550,8758,77,98,217.40,40.6
"2011","B17  8","B17  8","Total",9118,4683,4435,8851,267,177,243.24,37.5
"2011","B17  9","B17  9","Total",7610,3596,4014,7553,57,129,158.80,47.9
"2011","B18  4","B18  4","Total",6676,3579,3097,5773,903,37,89.76,74.4
"2011","B18  5","B18  5","Total",5132,2569,2563,5059,73,28,122.63,41.8
"2011","B18  6","B18  6","Total",1890,1017,873,1889,1,19,58.72,32.2
"2011","B18  7","B18  7","Total",2585,1222,1363,2585,0,14,51.43,50.3
"2011","B19  1","B19  1","Total",8818,4467,4351,8720,98,48,83.89,105.1
"2011","B19  2","B19  2","Total",7537,3711,3826,7520,17,63,108.95,69.2
"2011","B19  3","B19  3","Total",3713,1935,1778,3098,615,21,90.85,40.9
"2011","B2   4","B2   4","Total",451,264,187,450,1,2,21.63,20.9
"2011","B2   5","B2   5","Total",165,89,76,165,0,1,1.67,98.8
"2011","B20  1","B20  1","Total",8296,4057,4239,7994,302,131,311.62,26.6
"2011","B20  2","B20  2","Total",10818,5389,5429,10566,252,145,241.22,44.8
"2011","B20  3","B20  3","Total",14975,7744,7231,14918,57,131,171.83,87.2
"2011","B21  0","B21  0","Total",10012,5046,4966,9998,14,95,149.35,67.0
"2011","B21  8","B21  8","Total",9576,4699,4877,9573,3,68,195.48,49.0
"2011","B21  9","B21  9","Total",10738,5538,5200,10718,20,73,111.13,96.6
"2011","B23  5","B23  5","Total",15189,7232,7957,15041,148,96,284.40,53.4
"2011","B23  6","B23  6","Total",11113,5531,5582,10982,131,72,193.49,57.4
"2011","B23  7","B23  7","Total",16568,8081,8487,16465,103,109,327.27,50.6
"2011","B24  0","B24  0","Total",10567,5162,5405,10410,157,87,268.27,39.4
"2011","B24  8","B24  8","Total",8028,3945,4083,7849,179,54,194.15,41.3
"2011","B24  9","B24  9","Total",10275,5046,5229,10168,107,73,379.19,27.1
"2011","B25  8","B25  8","Total",16005,7774,8231,15963,42,78,353.14,45.3
"2011","B26  1","B26  1","Total",10895,5405,5490,10895,0,85,188.53,57.8
"2011","B26  2","B26  2","Total",11456,5601,5855,11411,45,73,210.01,54.5
"2011","B26  3","B26  3","Total",10475,5211,5264,10461,14,62,293.89,35.6
"2011","B27  6","B27  6","Total",9604,4824,4780,9363,241,81,169.90,56.5
"2011","B27  7","B27  7","Total",15230,7391,7839,15061,169,89,256.42,59.4
"2011","B28  0","B28  0","Total",14567,7154,7413,14507,60,199,316.00,46.1
"2011","B28  8","B28  8","Total",7734,3771,3963,7721,13,109,140.89,54.9
"2011","B28  9","B28  9","Total",7735,3800,3935,7733,2,74,127.52,60.7
"2011","B29  4","B29  4","Total",6122,2966,3156,6073,49,57,163.31,37.5
"2011","B29  5","B29  5","Total",10203,4836,5367,10188,15,78,195.10,52.3
"2011","B29  6","B29  6","Total",13598,6381,7217,12439,1159,133,248.19,54.8
"2011","B29  7","B29  7","Total",12101,5968,6133,11653,448,153,190.75,63.4
"2011","B3   1","B3   1","Total",2441,1425,1016,2441,0,4,33.61,72.6
"2011","B3   2","B3   2","Total",133,78,55,133,0,0,29.12,4.6
"2011","B30  1","B30  1","Total",10109,4712,5397,9914,195,139,270.90,37.3
"2011","B30  2","B30  2","Total",11521,5616,5905,11296,225,111,297.06,38.8
"2011","B30  3","B30  3","Total",7454,3615,3839,7246,208,53,205.50,36.3
"2011","B31  1","B31  1","Total",11388,5374,6014,11370,18,62,310.17,36.7
"2011","B31  2","B31  2","Total",12076,5887,6189,11987,89,111,309.64,39.0
"2011","B31  3","B31  3","Total",11150,5449,5701,11123,27,68,217.12,51.4
"2011","B31  4","B31  4","Total",9928,4799,5129,9918,10,48,187.21,53.0
"2011","B31  5","B31  5","Total",9760,4735,5025,9648,112,63,329.80,29.6
"2011","B32  1","B32  1","Total",9377,4486,4891,9369,8,74,230.81,40.6
"2011","B32  2","B32  2","Total",12079,5692,6387,12015,64,102,222.36,54.3
"2011","B32  3","B32  3","Total",11942,5643,6299,11690,252,69,393.18,30.4
"2011","B32  4","B32  4","Total",5120,2409,2711,5112,8,22,741.50,6.9
"2011","B33  0","B33  0","Total",10462,4979,5483,10377,85,32,331.53,31.6
"2011","B33  8","B33  8","Total",11937,5834,6103,11705,232,69,211.18,56.5
"2011","B33  9","B33  9","Total",12114,5754,6360,12109,5,51,272.10,44.5
"2011","B34  6","B34  6","Total",11167,5321,5846,11026,141,60,257.14,43.4
"2011","B34  7","B34  7","Total",8160,3809,4351,8157,3,36,209.61,38.9
"2011","B35  6","B35  6","Total",4240,2016,2224,4240,0,10,85.25,49.7
"2011","B35  7","B35  7","Total",5731,2566,3165,5586,145,36,223.21,25.7
"2011","B36  0","B36  0","Total",12698,6128,6570,12628,70,70,266.38,47.7
"2011","B36  8","B36  8","Total",12779,6113,6666,12744,35,83,244.17,52.3
"2011","B36  9","B36  9","Total",9274,4469,4805,9261,13,78,254.14,36.5
"2011","B37  5","B37  5","Total",9965,4776,5189,9909,56,37,216.39,46.1
"2011","B37  6","B37  6","Total",11857,5766,6091,11805,52,67,274.93,43.1
"2011","B37  7","B37  7","Total",13906,6765,7141,13723,183,72,692.82,20.1
"2011","B38  0","B38  0","Total",2084,985,1099,1864,220,28,631.24,3.3
"2011","B38  8","B38  8","Total",9201,4476,4725,9085,116,82,263.56,34.9
"2011","B38  9","B38  9","Total",10069,4752,5317,10029,40,44,231.70,43.5
"2011","B4   6","B4   6","Total",340,220,120,289,51,0,2.39,142.3
"2011","B4   7","B4   7","Total",4343,2147,2196,946,3397,92,147.15,29.5
"2011","B42  1","B42  1","Total",10974,5300,5674,10961,13,78,274.80,39.9
"2011","B42  2","B42  2","Total",13393,6436,6957,12712,681,108,509.06,26.3
"2011","B43  5","B43  5","Total",10947,5314,5633,10938,9,96,265.20,41.3
"2011","B43  6","B43  6","Total",6541,3203,3338,6541,0,86,299.49,21.8
"2011","B43  7","B43  7","Total",10953,5301,5652,10949,4,119,318.94,34.3
"2011","B44  0","B44  0","Total",15427,7403,8024,15365,62,73,224.94,68.6
"2011","B44  8","B44  8","Total",10020,4865,5155,9935,85,52,293.34,34.2
"2011","B44  9","B44  9","Total",11644,5521,6123,11582,62,51,227.24,51.2
"2011","B45  0","B45  0","Total",7143,3449,3694,7143,0,17,136.76,52.2
"2011","B45  8","B45  8","Total",10605,5180,5425,10440,165,181,1356.69,7.8
"2011","B45  9","B45  9","Total",12437,6095,6342,12374,63,113,654.88,19.0
"2011","B46  1","B46  1","Total",7223,3523,3700,7181,42,73,970.86,7.4
"2011","B46  2","B46  2","Total",2147,1103,1044,2137,10,36,3781.66,0.6
"2011","B46  3","B46  3","Total",2702,1286,1416,2598,104,30,760.18,3.6
"2011","B47  5","B47  5","Total",6596,3211,3385,6581,15,87,296.30,22.3
"2011","B47  6","B47  6","Total",2759,1342,1417,2736,23,39,815.10,3.4
"2011","B48  7","B48  7","Total",5796,2821,2975,5626,170,97,2697.92,2.1
"2011","B49  5","B49  5","Total",4344,2146,2198,4320,24,95,4065.42,1.1
"2011","B49  6","B49  6","Total",5845,2825,3020,5710,135,99,4184.90,1.4
"2011","B5   4","B5   4","Total",2134,1236,898,2130,4,10,45.40,47.0
"2011","B5   5","B5   5","Total",865,391,474,319,546,21,9.72,89.0
"2011","B5   6","B5   6","Total",222,118,104,222,0,2,0.93,238.7
"2011","B5   7","B5   7","Total",8762,4401,4361,7903,859,91,278.99,31.4
"2011","B50  4","B50  4","Total",5350,2608,2742,5273,77,69,1347.92,4.0
"2011","B6   4","B6   4","Total",1090,519,571,1090,0,6,47.18,23.1
"2011","B6   5","B6   5","Total",4388,2219,2169,4362,26,40,112.15,39.1
"2011","B6   6","B6   6","Total",11456,5824,5632,11423,33,71,118.67,96.5
"2011","B6   7","B6   7","Total",2730,1363,1367,2697,33,17,145.83,18.7
"2011","B60  1","B60  1","Total",7692,3755,3937,7529,163,127,1428.36,5.4
"2011","B60  2","B60  2","Total",7881,3775,4106,7792,89,133,294.00,26.8
"2011","B60  3","B60  3","Total",9030,4440,4590,9028,2,123,573.99,15.7
"2011","B60  4","B60  4","Total",3348,1685,1663,3303,45,44,2532.61,1.3
"2011","B61  0","B61  0","Total",10028,4888,5140,9899,129,115,1190.89,8.4
"2011","B61  7","B61  7","Total",5187,2597,2590,4774,413,86,219.94,23.6
"2011","B61  8","B61  8","Total",5803,2784,3019,5700,103,54,219.51,26.4
"2011","B61  9","B61  9","Total",2452,1222,1230,2452,0,57,2847.97,0.9
"2011","B62  0","B62  0","Total",6307,3092,3215,6230,77,92,1422.23,4.4
"2011","B62  8","B62  8","Total",8042,3996,4046,7993,49,90,627.74,12.8
"2011","B62  9","B62  9","Total",10052,4870,5182,9973,79,98,242.13,41.5
"2011","B63  1","B63  1","Total",5920,2873,3047,5897,23,101,233.68,25.3
"2011","B63  2","B63  2","Total",12109,5935,6174,12065,44,74,334.51,36.2
"2011","B63  3","B63  3","Total",7834,3818,4016,7817,17,80,291.76,26.9
"2011","B63  4","B63  4","Total",10568,5188,5380,10543,25,98,318.48,33.2
"2011","B64  5","B64  5","Total",3740,1825,1915,3736,4,17,116.05,32.2
"2011","B64  6","B64  6","Total",6879,3471,3408,6798,81,34,185.46,37.1
"2011","B64  7","B64  7","Total",5909,2834,3075,5850,59,40,185.21,31.9
"2011","B65  0","B65  0","Total",5899,2913,2986,5831,68,24,144.22,40.9
"2011","B65  8","B65  8","Total",7767,3800,3967,7765,2,35,276.16,28.1
"2011","B65  9","B65  9","Total",10104,4908,5196,10082,22,30,233.78,43.2
"2011","B66  1","B66  1","Total",3650,1799,1851,3593,57,26,171.45,21.3
"2011","B66  2","B66  2","Total",1588,770,818,1588,0,8,59.93,26.5
"2011","B66  3","B66  3","Total",7268,3622,3646,7215,53,59,233.24,31.2
"2011","B66  4","B66  4","Total",8828,4399,4429,8746,82,54,99.51,88.7
"2011","B67  5","B67  5","Total",9923,4767,5156,9860,63,105,192.38,51.6
"2011","B67  6","B67  6","Total",10540,5128,5412,10498,42,59,161.14,65.4
"2011","B67  7","B67  7","Total",9924,4971,4953,9837,87,71,172.05,57.7
"2011","B68  0","B68  0","Total",9240,4448,4792,9239,1,70,212.64,43.5
"2011","B68  8","B68  8","Total",9686,4776,4910,9639,47,55,237.21,40.8
"2011","B68  9","B68  9","Total",11662,5665,5997,11600,62,78,205.78,56.7
"2011","B69  1","B69  1","Total",14938,7328,7610,14772,166,80,306.91,48.7
"2011","B69  2","B69  2","Total",5166,2573,2593,5123,43,35,273.57,18.9
"2011","B69  3","B69  3","Total",3550,1747,1803,3550,0,28,146.41,24.2
"2011","B69  4","B69  4","Total",5304,2724,2580,5258,46,19,225.74,23.5
"2011","B7   4","B7   4","Total",3586,1770,1816,3586,0,22,118.59,30.2
"2011","B7   5","B7   5","Total",4960,2402,2558,4956,4,30,249.82,19.9
"2011","B70  0","B70  0","Total",6915,3430,3485,6901,14,60,406.23,17.0
"2011","B70  6","B70  6","Total",6871,3572,3299,6793,78,46,346.28,19.8
"2011","B70  7","B70  7","Total",3039,1525,1514,3031,8,12,146.26,20.8
"2011","B70  8","B70  8","Total",3915,1994,1921,3847,68,16,76.17,51.4
"2011","B70  9","B70  9","Total",7252,3742,3510,7144,108,50,208.69,34.8
"2011","B71  1","B71  1","Total",8545,4119,4426,8454,91,51,144.91,59.0
"2011","B71  2","B71  2","Total",10140,4930,5210,9957,183,59,243.88,41.6
"2011","B71  3","B71  3","Total",8645,4312,4333,8642,3,69,342.32,25.3
"2011","B71  4","B71  4","Total",3660,1786,1874,3644,16,15,234.50,15.6
"2011","B72  1","B72  1","Total",9569,4658,4911,9434,135,190,314.33,30.4
"2011","B73  5","B73  5","Total",13303,6483,6820,13154,149,257,298.34,44.6
"2011","B73  6","B73  6","Total",9498,4622,4876,9455,43,200,353.58,26.9
"2011","B74  2","B74  2","Total",9906,4829,5077,9820,86,183,1052.38,9.4
"2011","B74  3","B74  3","Total",11322,5497,5825,11229,93,208,779.42,14.5
"2011","B74  4","B74  4","Total",11242,5405,5837,11198,44,234,753.88,14.9
"2011","B75  5","B75  5","Total",8079,3910,4169,8079,0,146,558.69,14.5
"2011","B75  6","B75  6","Total",8894,4355,4539,8862,32,187,997.65,8.9
"2011","B75  7","B75  7","Total",9714,4624,5090,9702,12,105,323.37,30.0
"2011","B76  0","B76  0","Total",378,185,193,378,0,3,983.39,0.4
"2011","B76  1","B76  1","Total",11672,5663,6009,11612,60,209,557.58,20.9
"2011","B76  2","B76  2","Total",6525,3160,3365,6524,1,138,200.18,32.6
"2011","B76  9","B76  9","Total",3076,1519,1557,3076,0,33,2405.86,1.3
"2011","B77  1","B77  1","Total",10716,5331,5385,10654,62,119,852.49,12.6
"2011","B77  2","B77  2","Total",14627,7213,7414,14601,26,86,327.58,44.7
"2011","B77  3","B77  3","Total",8833,4311,4522,8811,22,80,184.39,47.9
"2011","B77  4","B77  4","Total",14200,6968,7232,14188,12,101,638.22,22.2
"2011","B77  5","B77  5","Total",8937,4409,4528,8917,20,98,348.02,25.7
"2011","B78  1","B78  1","Total",10197,5039,5158,10124,73,108,1718.39,5.9
"2011","B78  2","B78  2","Total",4379,2154,2225,4379,0,42,1345.43,3.3
"2011","B78  3","B78  3","Total",9798,4887,4911,9750,48,110,3520.25,2.8
"2011","B79  0","B79  0","Total",3210,1589,1621,3131,79,50,3211.98,1.0
"2011","B79  7","B79  7","Total",6117,2989,3128,6042,75,48,379.84,16.1
"2011","B79  8","B79  8","Total",10494,5028,5466,10359,135,118,595.54,17.6
"2011","B79  9","B79  9","Total",2305,1133,1172,2241,64,43,4787.72,0.5
"2011","B8   1","B8   1","Total",10570,5310,5260,10564,6,62,134.68,78.5
"2011","B8   2","B8   2","Total",15262,7528,7734,15192,70,76,282.94,53.9
"2011","B8   3","B8   3","Total",16097,8166,7931,16017,80,103,183.06,87.9
"2011","B80  7","B80  7","Total",7060,3444,3616,6983,77,81,3109.75,2.3
"2011","B9   4","B9   4","Total",4358,2205,2153,4328,30,26,184.84,23.6
"2011","B9   5","B9   5","Total",20545,10055,10490,20390,155,88,302.77,67.9
"2011","B90  1","B90  1","Total",10555,5197,5358,10495,60,129,650.99,16.2
"2011","B90  2","B90  2","Total",12790,6122,6668,12781,9,156,307.41,41.6
"2011","B90  3","B90  3","Total",10416,5055,5361,10379,37,156,260.87,39.9
"2011","B90  4","B90  4","Total",11598,5603,5995,11347,251,202,565.69,20.5
"2011","B91  1","B91  1","Total",10876,5313,5563,10819,57,335,411.39,26.4
"2011","B91  2","B91  2","Total",11752,5635,6117,11599,153,164,662.28,17.7
"2011","B91  3","B91  3","Total",10538,5158,5380,10478,60,354,528.60,19.9
"2011","B92  0","B92  0","Total",3980,1957,2023,3971,9,96,3146.92,1.3
"2011","B92  7","B92  7","Total",12664,6209,6455,12384,280,157,364.77,34.7
"2011","B92  8","B92  8","Total",12428,6009,6419,12353,75,139,274.81,45.2
"2011","B92  9","B92  9","Total",8173,3939,4234,8170,3,75,354.45,23.1
"2011","B93  0","B93  0","Total",3467,1641,1826,3386,81,76,1728.23,2.0
"2011","B93  8","B93  8","Total",7783,3800,3983,7776,7,272,762.13,10.2
"2011","B93  9","B93  9","Total",8456,4128,4328,8369,87,262,588.08,14.4
"2011","B94  5","B94  5","Total",3870,1926,1944,3869,1,82,4850.59,0.8
"2011","B94  6","B94  6","Total",3510,1756,1754,3508,2,107,1569.30,2.2
"2011","B95  5","B95  5","Total",3908,1873,2035,3861,47,83,2307.54,1.7
"2011","B95  6","B95  6","Total",1755,852,903,1755,0,28,2974.91,0.6
"2011","B96  6","B96  6","Total",5073,2475,2598,5073,0,89,4166.98,1.2
"2011","B97  4","B97  4","Total",5757,2872,2885,5605,152,54,253.83,22.7
"2011","B97  5","B97  5","Total",16741,8263,8478,16663,78,263,3490.36,4.8
"2011","B97  6","B97  6","Total",10996,5902,5094,9870,1126,78,1748.34,6.3
"2011","B98  0","B98  0","Total",14516,7270,7246,14509,7,135,591.20,24.6
"2011","B98  7","B98  7","Total",19783,9905,9878,19729,54,171,696.56,28.4
"2011","B98  8","B98  8","Total",9422,4728,4694,9411,11,60,349.93,26.9
"2011","B98  9","B98  9","Total",6337,3119,3218,6302,35,44,1255.93,5.0
"2011","BA1  1","BA1  1","Total",1875,972,903,1585,290,26,50.48,37.1
"2011","BA1  2","BA1  2","Total",6533,3328,3205,6423,110,101,136.71,47.8
"2011","BA1  3","BA1  3","Total",7564,3601,3963,7415,149,169,248.88,30.4
"2011","BA1  4","BA1  4","Total",5319,2528,2791,5298,21,94,208.13,25.6
"2011","BA1  5","BA1  5","Total",4524,2228,2296,4262,262,115,240.74,18.8
"2011","BA1  6","BA1  6","Total",8242,4076,4166,8193,49,117,164.70,50.0
"2011","BA1  7","BA1  7","Total",5514,2658,2856,5429,85,117,988.62,5.6
"2011","BA1  8","BA1  8","Total",904,442,462,897,7,34,2309.38,0.4
"2011","BA1  9","BA1  9","Total",248,118,130,248,0,14,846.57,0.3
"2011","BA10 0","BA10 0","Total",3739,1820,1919,3238,501,143,4235.23,0.9
"2011","BA11 1","BA11 1","Total",4992,2434,2558,4941,51,69,93.57,53.4
"2011","BA11 2","BA11 2","Total",10935,5358,5577,10841,94,148,2751.34,4.0
"2011","BA11 3","BA11 3","Total",4944,2421,2523,4836,108,66,2441.85,2.0
"2011","BA11 4","BA11 4","Total",6285,3052,3233,6172,113,60,814.03,7.7
"2011","BA11 5","BA11 5","Total",3424,1643,1781,3363,61,63,5742.46,0.6
"2011","BA11 6","BA11 6","Total",1874,912,962,1872,2,49,716.08,2.6
"2011","BA12 0","BA12 0","Total",5660,2748,2912,5611,49,189,15214.68,0.4
"2011","BA12 6","BA12 6","Total",4285,2096,2189,4212,73,111,6416.43,0.7
"2011","BA12 7","BA12 7","Total",3068,1473,1595,3023,45,112,11819.98,0.3
"2011","BA12 8","BA12 8","Total",8989,4342,4647,8770,219,138,1279.40,7.0
"2011","BA12 9","BA12 9","Total",6506,3140,3366,6317,189,110,893.44,7.3
"2011","BA13 2","BA13 2","Total",1303,627,676,1303,0,17,65.18,20.0
"2011","BA13 3","BA13 3","Total",12876,6213,6663,12740,136,114,1361.43,9.5
"2011","BA13 4","BA13 4","Total",6045,2966,3079,6036,9,154,6359.23,1.0
"2011","BA14 0","BA14 0","Total",12465,6132,6333,12431,34,127,834.45,14.9
"2011","BA14 6","BA14 6","Total",5938,2873,3065,5809,129,109,4435.61,1.3
"2011","BA14 7","BA14 7","Total",15181,7368,7813,15101,80,192,1088.83,13.9
"2011","BA14 8","BA14 8","Total",5810,2921,2889,5737,73,42,212.17,27.4
"2011","BA14 9","BA14 9","Total",8744,4254,4490,8611,133,129,1946.44,4.5
"2011","BA15 1","BA15 1","Total",9149,4307,4842,9133,16,178,684.92,13.4
"2011","BA15 2","BA15 2","Total",3990,1904,2086,3947,43,108,3031.98,1.3
"2011","BA16 0","BA16 0","Total",10396,5098,5298,9464,932,142,1024.38,10.1
"2011","BA16 9","BA16 9","Total",2645,1278,1367,2645,0,24,2059.70,1.3
"2011","BA2  0","BA2  0","Total",4579,2261,2318,4510,69,68,1872.30,2.4
"2011","BA2  1","BA2  1","Total",12851,6268,6583,12645,206,101,316.55,40.6
"2011","BA2  2","BA2  2","Total",10477,5130,5347,10446,31,142,244.05,42.9
"2011","BA2  3","BA2  3","Total",9376,4574,4802,8601,775,134,152.53,61.5
"2011","BA2  4","BA2  4","Total",6277,3136,3141,6033,244,169,197.87,31.7
"2011","BA2  5","BA2  5","Total",7220,3427,3793,7128,92,156,326.38,22.1
"2011","BA2  6","BA2  6","Total",6122,2984,3138,5890,232,170,678.68,9.0
"2011","BA2  7","BA2  7","Total",7173,3600,3573,4800,2373,178,5878.05,1.2
"2011","BA2  8","BA2  8","Total",7655,3769,3886,7651,4,105,2545.64,3.0
"2011","BA2  9","BA2  9","Total",2022,950,1072,1547,475,52,3460.46,0.6
"2011","BA20 1","BA20 1","Total",2173,1123,1050,2084,89,21,78.26,27.8
"2011","BA20 2","BA20 2","Total",8692,4253,4439,8484,208,104,474.81,18.3
"2011","BA21 3","BA21 3","Total",15100,7355,7745,14882,218,179,831.32,18.2
"2011","BA21 4","BA21 4","Total",8900,4411,4489,8812,88,121,224.28,39.7
"2011","BA21 5","BA21 5","Total",9619,4712,4907,9580,39,118,1193.67,8.1
"2011","BA22 7","BA22 7","Total",3881,1909,1972,3772,109,108,6256.13,0.6
"2011","BA22 8","BA22 8","Total",8965,4895,4070,7831,1134,194,6385.02,1.4
"2011","BA22 9","BA22 9","Total",5320,2624,2696,5316,4,104,6006.47,0.9
"2011","BA3  2","BA3  2","Total",9801,4813,4988,9742,59,124,465.43,21.1
"2011","BA3  3","BA3  3","Total",10411,5134,5277,10375,36,97,803.44,13.0
"2011","BA3  4","BA3  4","Total",7556,3803,3753,7095,461,163,6877.80,1.1
"2011","BA3  5","BA3  5","Total",6942,3425,3517,6849,93,100,5951.10,1.2
"2011","BA4  4","BA4  4","Total",5159,2554,2605,5028,131,100,8410.53,0.6
"2011","BA4  5","BA4  5","Total",8299,4225,4074,8090,209,79,385.55,21.5
"2011","BA4  6","BA4  6","Total",4317,2109,2208,4261,56,119,7343.34,0.6
"2011","BA5  1","BA5  1","Total",6065,2887,3178,5897,168,142,6704.58,0.9
"2011","BA5  2","BA5  2","Total",7253,3395,3858,6990,263,141,407.37,17.8
"2011","BA5  3","BA5  3","Total",4216,2009,2207,4128,88,82,4590.12,0.9
"2011","BA6  8","BA6  8","Total",6437,3116,3321,6189,248,151,6608.92,1.0
"2011","BA6  9","BA6  9","Total",6433,3130,3303,6276,157,94,2650.86,2.4
"2011","BA7  7","BA7  7","Total",3514,1653,1861,3396,118,54,1682.57,2.1
"2011","BA8  0","BA8  0","Total",4153,2047,2106,4117,36,76,4127.10,1.0
"2011","BA9  8","BA9  8","Total",1484,710,774,1443,41,63,4865.37,0.3
"2011","BA9  9","BA9  9","Total",5758,2796,2962,5685,73,101,2541.25,2.3
"2011","BB1  1","BB1  1","Total",12317,6228,6089,12282,35,134,242.28,50.8
"2011","BB1  2","BB1  2","Total",9179,4676,4503,8943,236,58,1002.70,9.2
"2011","BB1  3","BB1  3","Total",2784,1387,1397,2784,0,18,67.79,41.1
"2011","BB1  4","BB1  4","Total",6625,3296,3329,6623,2,53,1107.97,6.0
"2011","BB1  5","BB1  5","Total",7773,3881,3892,7735,38,41,344.00,22.6
"2011","BB1  6","BB1  6","Total",3458,1750,1708,3441,17,33,39.36,87.9
"2011","BB1  7","BB1  7","Total",4369,2235,2134,4337,32,42,47.36,92.3
"2011","BB1  8","BB1  8","Total",9813,4882,4931,9670,143,114,222.98,44.0
"2011","BB1  9","BB1  9","Total",10227,4931,5296,10064,163,166,1911.96,5.3
"2011","BB10 1","BB10 1","Total",8813,4503,4310,8665,148,86,330.13,26.7
"2011","BB10 2","BB10 2","Total",10448,5104,5344,10392,56,126,299.44,34.9
"2011","BB10 3","BB10 3","Total",7988,3931,4057,7947,41,63,3459.82,2.3
"2011","BB10 4","BB10 4","Total",10183,4952,5231,10152,31,105,2942.17,3.5
"2011","BB11 2","BB11 2","Total",5203,2523,2680,5050,153,69,230.15,22.6
"2011","BB11 3","BB11 3","Total",4093,1991,2102,4009,84,48,180.82,22.6
"2011","BB11 4","BB11 4","Total",6065,2972,3093,5952,113,40,133.68,45.4
"2011","BB11 5","BB11 5","Total",6860,3366,3494,6835,25,71,2319.97,3.0
"2011","BB12 0","BB12 0","Total",8089,4110,3979,8075,14,88,340.79,23.7
"2011","BB12 6","BB12 6","Total",8530,4101,4429,8427,103,70,422.97,20.2
"2011","BB12 7","BB12 7","Total",7169,3531,3638,7129,40,97,1411.28,5.1
"2011","BB12 8","BB12 8","Total",7891,3828,4063,7757,134,93,411.62,19.2
"2011","BB12 9","BB12 9","Total",2934,1435,1499,2932,2,48,3126.60,0.9
"2011","BB18 5","BB18 5","Total",7710,3843,3867,7688,22,67,2669.21,2.9
"2011","BB18 6","BB18 6","Total",9469,4643,4826,9407,62,105,1739.85,5.4
"2011","BB2  1","BB2  1","Total",5685,3014,2671,5478,207,32,106.92,53.2
"2011","BB2  2","BB2  2","Total",4447,2270,2177,4407,40,29,107.81,41.2
"2011","BB2  3","BB2  3","Total",9919,4853,5066,9720,199,51,228.10,43.5
"2011","BB2  4","BB2  4","Total",15182,7495,7687,15123,59,112,406.28,37.4
"2011","BB2  5","BB2  5","Total",7070,3461,3609,6992,78,122,635.04,11.1
"2011","BB2  6","BB2  6","Total",10432,5256,5176,10205,227,163,881.21,11.8
"2011","BB2  7","BB2  7","Total",7189,3542,3647,7142,47,169,2589.55,2.8
"2011","BB3  0","BB3  0","Total",9303,4569,4734,9089,214,77,1360.67,6.8
"2011","BB3  1","BB3  1","Total",6392,3119,3273,6373,19,48,224.95,28.4
"2011","BB3  2","BB3  2","Total",9402,4720,4682,9377,25,96,1311.04,7.2
"2011","BB3  3","BB3  3","Total",9406,4654,4752,9390,16,74,1330.20,7.1
"2011","BB4  4","BB4  4","Total",7473,3604,3869,7249,224,121,2357.21,3.2
"2011","BB4  5","BB4  5","Total",6006,2970,3036,5980,26,44,1031.24,5.8
"2011","BB4  6","BB4  6","Total",7795,3798,3997,7719,76,113,611.42,12.7
"2011","BB4  7","BB4  7","Total",5874,2907,2967,5803,71,70,795.06,7.4
"2011","BB4  8","BB4  8","Total",8676,4280,4396,8610,66,144,1212.14,7.2
"2011","BB4  9","BB4  9","Total",5577,2747,2830,5505,72,55,1546.51,3.6
"2011","BB5  0","BB5  0","Total",9702,4795,4907,9621,81,47,203.73,47.6
"2011","BB5  1","BB5  1","Total",4946,2502,2444,4893,53,34,94.60,52.3
"2011","BB5  2","BB5  2","Total",7686,3829,3857,7634,52,87,592.90,13.0
"2011","BB5  3","BB5  3","Total",7911,3914,3997,7878,33,61,1241.81,6.4
"2011","BB5  4","BB5  4","Total",8846,4326,4520,8760,86,63,408.54,21.7
"2011","BB5  5","BB5  5","Total",11513,5598,5915,11288,225,111,1080.68,10.7
"2011","BB5  6","BB5  6","Total",10498,5244,5254,10432,66,95,775.39,13.5
"2011","BB6  7","BB6  7","Total",10800,5324,5476,10752,48,105,1221.88,8.8
"2011","BB6  8","BB6  8","Total",3859,1941,1918,3789,70,96,1088.20,3.5
"2011","BB7  1","BB7  1","Total",7591,3711,3880,7526,65,95,2301.97,3.3
"2011","BB7  2","BB7  2","Total",7177,3462,3715,7053,124,110,422.28,17.0
"2011","BB7  3","BB7  3","Total",3067,1520,1547,3066,1,65,23545.55,0.1
"2011","BB7  4","BB7  4","Total",5080,2525,2555,4974,106,110,11982.70,0.4
"2011","BB7  9","BB7  9","Total",8784,4377,4407,8237,547,179,3552.24,2.5
"2011","BB8  0","BB8  0","Total",6062,2969,3093,5981,81,46,163.16,37.2
"2011","BB8  7","BB8  7","Total",4630,2272,2358,4610,20,61,2677.02,1.7
"2011","BB8  8","BB8  8","Total",5092,2515,2577,5078,14,48,2822.72,1.8
"2011","BB8  9","BB8  9","Total",7257,3527,3730,7180,77,53,340.83,21.3
"2011","BB9  0","BB9  0","Total",12189,5990,6199,12109,80,123,374.59,32.5
"2011","BB9  5","BB9  5","Total",6357,3156,3201,6307,50,56,191.91,33.1
"2011","BB9  6","BB9  6","Total",4788,2325,2463,4707,81,84,1663.50,2.9
"2011","BB9  7","BB9  7","Total",6726,3349,3377,6723,3,75,133.80,50.3
"2011","BB9  8","BB9  8","Total",8116,3939,4177,8089,27,66,228.59,35.5
"2011","BB9  9","BB9  9","Total",6422,3176,3246,6335,87,51,454.45,14.1
"2011","BD1  1","BD1  1","Total",384,241,143,384,0,1,22.97,16.7
"2011","BD1  2","BD1  2","Total",370,222,148,370,0,4,13.91,26.6
"2011","BD1  3","BD1  3","Total",1575,855,720,1575,0,6,31.31,50.3
"2011","BD1  4","BD1  4","Total",751,470,281,747,4,2,28.75,26.1
"2011","BD1  5","BD1  5","Total",756,464,292,756,0,7,11.01,68.7
"2011","BD10 0","BD10 0","Total",8834,4283,4551,8729,105,102,576.27,15.3
"2011","BD10 8","BD10 8","Total",10627,5204,5423,10567,60,105,260.58,40.8
"2011","BD10 9","BD10 9","Total",6421,3118,3303,6339,82,40,127.66,50.3
"2011","BD11 1","BD11 1","Total",5528,2735,2793,5482,46,45,458.96,12.0
"2011","BD11 2","BD11 2","Total",5827,2783,3044,5760,67,51,558.35,10.4
"2011","BD12 0","BD12 0","Total",5308,2592,2716,5284,24,43,272.59,19.5
"2011","BD12 7","BD12 7","Total",1901,921,980,1899,2,21,191.65,9.9
"2011","BD12 8","BD12 8","Total",4908,2407,2501,4906,2,26,308.61,15.9
"2011","BD12 9","BD12 9","Total",4568,2209,2359,4553,15,28,291.40,15.7
"2011","BD13 1","BD13 1","Total",3967,1934,2033,3946,21,31,483.55,8.2
"2011","BD13 2","BD13 2","Total",7657,3736,3921,7613,44,63,419.49,18.3
"2011","BD13 3","BD13 3","Total",6934,3388,3546,6860,74,63,1000.14,6.9
"2011","BD13 4","BD13 4","Total",3489,1717,1772,3489,0,32,1025.49,3.4
"2011","BD13 5","BD13 5","Total",2932,1382,1550,2932,0,56,906.03,3.2
"2011","BD14 6","BD14 6","Total",8871,3966,4905,8291,580,102,401.56,22.1
"2011","BD15 0","BD15 0","Total",4248,1987,2261,4187,61,76,466.63,9.1
"2011","BD15 7","BD15 7","Total",8060,3902,4158,8029,31,39,236.53,34.1
"2011","BD15 9","BD15 9","Total",3008,1485,1523,3008,0,24,147.37,20.4
"2011","BD16 1","BD16 1","Total",9433,4560,4873,9390,43,118,1424.23,6.6
"2011","BD16 2","BD16 2","Total",3422,1664,1758,3422,0,54,215.49,15.9
"2011","BD16 3","BD16 3","Total",5776,2839,2937,5776,0,127,1395.69,4.1
"2011","BD16 4","BD16 4","Total",7172,3641,3531,7078,94,145,209.16,34.3
"2011","BD17 5","BD17 5","Total",8187,4027,4160,8187,0,106,871.98,9.4
"2011","BD17 6","BD17 6","Total",6188,2949,3239,6102,86,82,162.14,38.2
"2011","BD17 7","BD17 7","Total",3526,1767,1759,3526,0,25,606.71,5.8
"2011","BD18 1","BD18 1","Total",7192,3533,3659,7192,0,51,179.26,40.1
"2011","BD18 2","BD18 2","Total",6828,3342,3486,6826,2,52,164.63,41.5
"2011","BD18 3","BD18 3","Total",5448,2719,2729,5357,91,57,192.35,28.3
"2011","BD18 4","BD18 4","Total",7790,3740,4050,7615,175,111,307.92,25.3
"2011","BD19 3","BD19 3","Total",5989,2978,3011,5910,79,40,193.35,31.0
"2011","BD19 4","BD19 4","Total",9436,4628,4808,9379,57,77,643.67,14.7
"2011","BD19 5","BD19 5","Total",2646,1298,1348,2646,0,15,108.46,24.4
"2011","BD19 6","BD19 6","Total",3948,1958,1990,3898,50,34,473.42,8.3
"2011","BD2  1","BD2  1","Total",8149,4011,4138,8129,20,63,187.93,43.4
"2011","BD2  2","BD2  2","Total",4754,2267,2487,4754,0,31,80.52,59.0
"2011","BD2  3","BD2  3","Total",7927,3863,4064,7905,22,63,161.50,49.1
"2011","BD2  4","BD2  4","Total",7736,3740,3996,7668,68,63,135.52,57.1
"2011","BD20 0","BD20 0","Total",6137,2992,3145,6075,62,50,1745.31,3.5
"2011","BD20 5","BD20 5","Total",7284,3562,3722,7238,46,88,1507.23,4.8
"2011","BD20 6","BD20 6","Total",7399,3593,3806,7085,314,101,1004.98,7.4
"2011","BD20 7","BD20 7","Total",4908,2332,2576,4781,127,83,1104.85,4.4
"2011","BD20 8","BD20 8","Total",5509,2619,2890,5361,148,86,2102.70,2.6
"2011","BD20 9","BD20 9","Total",4078,1922,2156,3938,140,81,2452.48,1.7
"2011","BD21 1","BD21 1","Total",6041,2924,3117,6022,19,16,102.26,59.1
"2011","BD21 2","BD21 2","Total",7158,3596,3562,7147,11,43,101.06,70.8
"2011","BD21 3","BD21 3","Total",3931,2000,1931,3928,3,14,59.33,66.3
"2011","BD21 4","BD21 4","Total",7373,3691,3682,7341,32,49,606.21,12.2
"2011","BD21 5","BD21 5","Total",2630,1326,1304,2630,0,11,257.79,10.2
"2011","BD22 0","BD22 0","Total",4465,2255,2210,4454,11,82,5816.58,0.8
"2011","BD22 6","BD22 6","Total",7683,3665,4018,7642,41,66,276.37,27.8
"2011","BD22 7","BD22 7","Total",9056,4373,4683,9036,20,87,362.60,25.0
"2011","BD22 8","BD22 8","Total",4270,2092,2178,4193,77,36,205.58,20.8
"2011","BD22 9","BD22 9","Total",4375,2118,2257,4375,0,62,1874.49,2.3
"2011","BD23 1","BD23 1","Total",5900,2845,3055,5890,10,132,273.78,21.6
"2011","BD23 2","BD23 2","Total",8348,3987,4361,8299,49,87,1106.67,7.5
"2011","BD23 3","BD23 3","Total",4100,1969,2131,3991,109,71,10610.57,0.4
"2011","BD23 4","BD23 4","Total",3569,1772,1797,3532,37,85,18042.36,0.2
"2011","BD23 5","BD23 5","Total",3485,1654,1831,3376,109,76,26528.38,0.1
"2011","BD23 6","BD23 6","Total",3927,1908,2019,3846,81,106,17915.21,0.2
"2011","BD24 0","BD24 0","Total",2003,1003,1000,1804,199,58,10291.15,0.2
"2011","BD24 9","BD24 9","Total",3128,1497,1631,3071,57,58,4348.27,0.7
"2011","BD3  0","BD3  0","Total",9775,4886,4889,9721,54,53,206.73,47.3
"2011","BD3  7","BD3  7","Total",7518,3710,3808,7368,150,35,150.17,50.1
"2011","BD3  8","BD3  8","Total",9087,4604,4483,9046,41,43,94.76,95.9
"2011","BD3  9","BD3  9","Total",7641,3910,3731,7604,37,25,78.61,97.2
"2011","BD4  0","BD4  0","Total",6698,3259,3439,6698,0,26,916.06,7.3
"2011","BD4  6","BD4  6","Total",7253,3519,3734,7159,94,42,363.79,19.9
"2011","BD4  7","BD4  7","Total",4767,2356,2411,4765,2,19,139.59,34.2
"2011","BD4  8","BD4  8","Total",6867,3342,3525,6867,0,23,416.53,16.5
"2011","BD4  9","BD4  9","Total",5633,2730,2903,5389,244,22,155.14,36.3
"2011","BD5  0","BD5  0","Total",7093,3823,3270,6443,650,75,113.32,62.6
"2011","BD5  7","BD5  7","Total",6312,3228,3084,6262,50,30,88.67,71.2
"2011","BD5  8","BD5  8","Total",7748,3863,3885,7747,1,32,213.31,36.3
"2011","BD5  9","BD5  9","Total",10488,5171,5317,10475,13,65,125.95,83.3
"2011","BD6  1","BD6  1","Total",9491,4531,4960,9467,24,42,251.49,37.7
"2011","BD6  2","BD6  2","Total",7616,3627,3989,7508,108,44,152.86,49.8
"2011","BD6  3","BD6  3","Total",12965,6252,6713,12919,46,90,251.71,51.5
"2011","BD7  1","BD7  1","Total",6140,3463,2677,4259,1881,108,148.26,41.4
"2011","BD7  2","BD7  2","Total",11830,5936,5894,11826,4,79,223.18,53.0
"2011","BD7  3","BD7  3","Total",8650,4411,4239,8586,64,56,116.59,74.2
"2011","BD7  4","BD7  4","Total",8725,4198,4527,8652,73,84,167.42,52.1
"2011","BD8  0","BD8  0","Total",7933,3802,4131,7761,172,50,186.61,42.5
"2011","BD8  7","BD8  7","Total",6679,3575,3104,6432,247,42,199.37,33.5
"2011","BD8  8","BD8  8","Total",6659,3398,3261,6659,0,24,70.96,93.8
"2011","BD8  9","BD8  9","Total",10231,5129,5102,10230,1,54,86.15,118.8
"2011","BD9  4","BD9  4","Total",9552,4843,4709,9305,247,75,173.80,55.0
"2011","BD9  5","BD9  5","Total",10933,5425,5508,10813,120,78,129.75,84.3
"2011","BD9  6","BD9  6","Total",8824,4298,4526,8765,59,75,369.40,23.9
"2011","BH1  1","BH1  1","Total",2648,1481,1167,2630,18,12,55.40,47.8
"2011","BH1  2","BH1  2","Total",1096,573,523,1071,25,12,18.86,58.1
"2011","BH1  3","BH1  3","Total",6470,3490,2980,5956,514,42,147.06,44.0
"2011","BH1  4","BH1  4","Total",9090,4831,4259,9033,57,66,86.55,105.0
"2011","BH10 4","BH10 4","Total",4123,1998,2125,4073,50,39,114.26,36.1
"2011","BH10 5","BH10 5","Total",7037,3437,3600,7031,6,50,158.47,44.4
"2011","BH10 6","BH10 6","Total",5043,2409,2634,4972,71,55,137.41,36.7
"2011","BH10 7","BH10 7","Total",3859,1909,1950,3859,0,33,222.46,17.3
"2011","BH11 8","BH11 8","Total",9887,4778,5109,9883,4,56,277.16,35.7
"2011","BH11 9","BH11 9","Total",10023,4890,5133,9998,25,64,428.87,23.4
"2011","BH12 1","BH12 1","Total",6253,3117,3136,6219,34,61,199.54,31.3
"2011","BH12 2","BH12 2","Total",7955,3944,4011,7949,6,69,130.48,61.0
"2011","BH12 3","BH12 3","Total",8011,3952,4059,8001,10,59,140.92,56.8
"2011","BH12 4","BH12 4","Total",8709,4223,4486,8591,118,59,328.31,26.5
"2011","BH12 5","BH12 5","Total",4343,2153,2190,4034,309,39,152.49,28.5
"2011","BH13 6","BH13 6","Total",4570,2154,2416,4293,277,67,193.82,23.6
"2011","BH13 7","BH13 7","Total",3751,1891,1860,3646,105,92,312.86,12.0
"2011","BH14 0","BH14 0","Total",7000,3424,3576,6856,144,53,157.42,44.5
"2011","BH14 8","BH14 8","Total",9262,4528,4734,9181,81,133,341.86,27.1
"2011","BH14 9","BH14 9","Total",7170,3583,3587,7065,105,126,186.61,38.4
"2011","BH15 1","BH15 1","Total",6176,2973,3203,5735,441,44,162.25,38.1
"2011","BH15 2","BH15 2","Total",6073,2937,3136,5947,126,48,150.75,40.3
"2011","BH15 3","BH15 3","Total",11277,5425,5852,11221,56,147,339.63,33.2
"2011","BH15 4","BH15 4","Total",9526,4760,4766,9420,106,64,371.25,25.7
"2011","BH16 5","BH16 5","Total",10947,5293,5654,10947,0,93,558.32,19.6
"2011","BH16 6","BH16 6","Total",4888,2394,2494,4838,50,119,3581.84,1.4
"2011","BH17 7","BH17 7","Total",8904,4299,4605,8891,13,64,355.87,25.0
"2011","BH17 8","BH17 8","Total",7525,3663,3862,7466,59,48,196.88,38.2
"2011","BH17 9","BH17 9","Total",6554,3188,3366,6554,0,101,314.76,20.8
"2011","BH18 8","BH18 8","Total",4652,2180,2472,4555,97,106,354.43,13.1
"2011","BH18 9","BH18 9","Total",6476,3149,3327,6476,0,140,304.44,21.3
"2011","BH19 1","BH19 1","Total",4077,1941,2136,3931,146,49,606.48,6.7
"2011","BH19 2","BH19 2","Total",5524,2680,2844,5487,37,106,514.91,10.7
"2011","BH19 3","BH19 3","Total",1916,950,966,1872,44,45,4055.76,0.5
"2011","BH2  5","BH2  5","Total",4479,2480,1999,4354,125,32,98.17,45.6
"2011","BH2  6","BH2  6","Total",3866,1913,1953,3678,188,31,85.70,45.1
"2011","BH20 4","BH20 4","Total",5496,2563,2933,5461,35,80,635.37,8.7
"2011","BH20 5","BH20 5","Total",3940,1971,1969,3903,37,82,12733.44,0.3
"2011","BH20 6","BH20 6","Total",5953,3081,2872,5656,297,90,4190.42,1.4
"2011","BH20 7","BH20 7","Total",4565,2277,2288,4557,8,67,8277.62,0.6
"2011","BH21 1","BH21 1","Total",10432,4891,5541,10276,156,167,677.14,15.4
"2011","BH21 2","BH21 2","Total",9008,4353,4655,8964,44,163,825.46,10.9
"2011","BH21 3","BH21 3","Total",10677,5247,5430,10277,400,176,2177.37,4.9
"2011","BH21 4","BH21 4","Total",2220,1117,1103,2220,0,49,2954.47,0.8
"2011","BH21 5","BH21 5","Total",2407,1188,1219,2355,52,69,9390.32,0.3
"2011","BH21 6","BH21 6","Total",1492,692,800,1428,64,19,424.96,3.5
"2011","BH21 7","BH21 7","Total",3813,1846,1967,3777,36,85,5203.38,0.7
"2011","BH21 8","BH21 8","Total",522,272,250,522,0,6,1048.80,0.5
"2011","BH22 0","BH22 0","Total",7561,3563,3998,7414,147,52,853.75,8.9
"2011","BH22 8","BH22 8","Total",10856,5262,5594,10746,110,131,962.63,11.3
"2011","BH22 9","BH22 9","Total",8374,3894,4480,8223,151,80,586.00,14.3
"2011","BH23 1","BH23 1","Total",5592,2659,2933,5556,36,60,220.90,25.3
"2011","BH23 2","BH23 2","Total",12055,5870,6185,11909,146,113,633.85,19.0
"2011","BH23 3","BH23 3","Total",8891,4320,4571,8860,31,61,296.81,30.0
"2011","BH23 4","BH23 4","Total",9687,4562,5125,9568,119,95,482.13,20.1
"2011","BH23 5","BH23 5","Total",6849,3180,3669,6773,76,76,300.90,22.8
"2011","BH23 6","BH23 6","Total",501,270,231,478,23,3,2235.47,0.2
"2011","BH23 7","BH23 7","Total",4485,2167,2318,4400,85,49,1186.80,3.8
"2011","BH23 8","BH23 8","Total",4758,2280,2478,4721,37,92,3052.34,1.6
"2011","BH24 1","BH24 1","Total",10473,4984,5489,10322,151,120,498.39,21.0
"2011","BH24 2","BH24 2","Total",6859,3327,3532,6660,199,104,2480.70,2.8
"2011","BH24 3","BH24 3","Total",4879,2386,2493,4788,91,106,7805.67,0.6
"2011","BH24 4","BH24 4","Total",1384,642,742,1324,60,29,4552.97,0.3
"2011","BH25 5","BH25 5","Total",12352,5855,6497,12065,287,151,1474.90,8.4
"2011","BH25 6","BH25 6","Total",6598,2993,3605,6413,185,38,286.76,23.0
"2011","BH25 7","BH25 7","Total",6767,3089,3678,6574,193,62,323.17,20.9
"2011","BH3  7","BH3  7","Total",5740,2892,2848,5597,143,108,211.43,27.1
"2011","BH31 6","BH31 6","Total",10168,4964,5204,10168,0,114,789.24,12.9
"2011","BH31 7","BH31 7","Total",3192,1517,1675,3173,19,32,537.96,5.9
"2011","BH4  8","BH4  8","Total",5323,2620,2703,5096,227,23,111.45,47.8
"2011","BH4  9","BH4  9","Total",4059,2006,2053,3873,186,37,114.66,35.4
"2011","BH5  1","BH5  1","Total",6383,3333,3050,6003,380,26,94.33,67.7
"2011","BH5  2","BH5  2","Total",4863,2470,2393,4716,147,59,88.47,55.0
"2011","BH6  3","BH6  3","Total",9043,4271,4772,8585,458,95,173.12,52.2
"2011","BH6  4","BH6  4","Total",3617,1708,1909,3538,79,50,302.23,12.0
"2011","BH6  5","BH6  5","Total",9539,4659,4880,9463,76,93,178.15,53.5
"2011","BH7  6","BH7  6","Total",8130,4041,4089,8123,7,94,194.90,41.7
"2011","BH7  7","BH7  7","Total",3690,1798,1892,3638,52,74,196.57,18.8
"2011","BH8  0","BH8  0","Total",7307,3441,3866,7241,66,55,261.96,27.9
"2011","BH8  8","BH8  8","Total",12631,6549,6082,11466,1165,137,158.45,79.7
"2011","BH8  9","BH8  9","Total",8077,3951,4126,7926,151,126,322.25,25.1
"2011","BH9  1","BH9  1","Total",12693,6295,6398,12605,88,130,161.84,78.4
"2011","BH9  2","BH9  2","Total",8878,4332,4546,8859,19,124,144.38,61.5
"2011","BH9  3","BH9  3","Total",10048,4902,5146,10013,35,110,287.92,34.9
"2011","BL0  0","BL0  0","Total",5575,2681,2894,5535,40,100,2297.85,2.4
"2011","BL0  9","BL0  9","Total",12178,5935,6243,12146,32,230,382.42,31.8
"2011","BL1  1","BL1  1","Total",413,264,149,371,42,0,27.60,15.0
"2011","BL1  2","BL1  2","Total",4243,2241,2002,4229,14,26,165.90,25.6
"2011","BL1  3","BL1  3","Total",9919,4979,4940,9897,22,65,127.84,77.6
"2011","BL1  4","BL1  4","Total",9093,4656,4437,9051,42,73,183.90,49.4
"2011","BL1  5","BL1  5","Total",12151,5890,6261,12074,77,236,733.46,16.6
"2011","BL1  6","BL1  6","Total",8641,4206,4435,8613,28,92,748.84,11.5
"2011","BL1  7","BL1  7","Total",8374,4164,4210,8354,20,119,597.80,14.0
"2011","BL1  8","BL1  8","Total",10965,5451,5514,10937,28,116,232.94,47.1
"2011","BL2  1","BL2  1","Total",3922,2008,1914,3654,268,45,88.62,44.3
"2011","BL2  2","BL2  2","Total",8402,4012,4390,8398,4,49,179.32,46.9
"2011","BL2  3","BL2  3","Total",8526,4099,4427,8523,3,112,354.16,24.1
"2011","BL2  4","BL2  4","Total",4708,2285,2423,4708,0,78,697.36,6.8
"2011","BL2  5","BL2  5","Total",9312,4449,4863,9237,75,61,260.67,35.7
"2011","BL2  6","BL2  6","Total",10663,5161,5502,10521,142,92,582.91,18.3
"2011","BL3  1","BL3  1","Total",12315,6026,6289,12305,10,81,467.15,26.4
"2011","BL3  2","BL3  2","Total",9408,4746,4662,9373,35,82,293.38,32.1
"2011","BL3  3","BL3  3","Total",14867,7287,7580,14794,73,105,276.47,53.8
"2011","BL3  4","BL3  4","Total",14244,7175,7069,14073,171,124,377.16,37.8
"2011","BL3  5","BL3  5","Total",7974,4083,3891,7942,32,58,154.84,51.5
"2011","BL3  6","BL3  6","Total",5470,2845,2625,5119,351,49,129.66,42.2
"2011","BL4  0","BL4  0","Total",10178,4981,5197,10127,51,61,226.50,44.9
"2011","BL4  7","BL4  7","Total",6773,3337,3436,6773,0,31,211.81,32.0
"2011","BL4  8","BL4  8","Total",8127,3936,4191,7977,150,44,409.37,19.9
"2011","BL4  9","BL4  9","Total",8372,4057,4315,8372,0,38,185.90,45.0
"2011","BL5  1","BL5  1","Total",2664,1291,1373,2664,0,35,895.57,3.0
"2011","BL5  2","BL5  2","Total",12536,6155,6381,12535,1,164,615.68,20.4
"2011","BL5  3","BL5  3","Total",11840,5879,5961,11808,32,138,1151.86,10.3
"2011","BL6  4","BL6  4","Total",5996,3017,2979,5938,58,129,860.22,7.0
"2011","BL6  5","BL6  5","Total",10071,4965,5106,9959,112,91,958.41,10.5
"2011","BL6  6","BL6  6","Total",6889,3373,3516,6887,2,95,1084.87,6.4
"2011","BL6  7","BL6  7","Total",6472,3091,3381,6392,80,70,1258.08,5.1
"2011","BL7  0","BL7  0","Total",3180,1549,1631,3180,0,78,2982.38,1.1
"2011","BL7  8","BL7  8","Total",687,347,340,687,0,13,2399.00,0.3
"2011","BL7  9","BL7  9","Total",11092,5440,5652,11087,5,171,596.09,18.6
"2011","BL8  1","BL8  1","Total",12753,6218,6535,12652,101,171,396.29,32.2
"2011","BL8  2","BL8  2","Total",10344,5009,5335,10137,207,159,371.65,27.8
"2011","BL8  3","BL8  3","Total",8287,4035,4252,8094,193,111,835.07,9.9
"2011","BL8  4","BL8  4","Total",4413,2292,2121,4181,232,139,1026.84,4.3
"2011","BL9  0","BL9  0","Total",2526,1277,1249,2484,42,19,97.85,25.8
"2011","BL9  5","BL9  5","Total",6689,3290,3399,6502,187,76,578.32,11.6
"2011","BL9  6","BL9  6","Total",8736,4356,4380,8646,90,79,2100.38,4.2
"2011","BL9  7","BL9  7","Total",9964,4917,5047,9863,101,83,586.79,17.0
"2011","BL9  8","BL9  8","Total",9409,4605,4804,9399,10,151,929.64,10.1
"2011","BL9  9","BL9  9","Total",10898,5380,5518,10833,65,119,338.81,32.2
"2011","BN1  1","BN1  1","Total",2003,1146,857,1929,74,11,50.30,39.8
"2011","BN1  2","BN1  2","Total",4947,2770,2177,4898,49,15,39.27,126.0
"2011","BN1  3","BN1  3","Total",10243,5454,4789,10216,27,64,58.00,176.6
"2011","BN1  4","BN1  4","Total",8809,4545,4264,8443,366,72,75.93,116.0
"2011","BN1  5","BN1  5","Total",10150,5069,5081,10094,56,137,686.91,14.8
"2011","BN1  6","BN1  6","Total",17167,8359,8808,16978,189,306,284.34,60.4
"2011","BN1  7","BN1  7","Total",8422,4179,4243,8286,136,87,196.66,42.8
"2011","BN1  8","BN1  8","Total",14489,6965,7524,14407,82,160,809.99,17.9
"2011","BN1  9","BN1  9","Total",8545,4071,4474,4982,3563,134,2233.41,3.8
"2011","BN10 7","BN10 7","Total",9126,4445,4681,9050,76,51,451.16,20.2
"2011","BN10 8","BN10 8","Total",9453,4582,4871,9358,95,43,413.95,22.8
"2011","BN11 1","BN11 1","Total",4628,2287,2341,4526,102,52,66.18,69.9
"2011","BN11 2","BN11 2","Total",9066,4353,4713,8798,268,71,202.73,44.7
"2011","BN11 3","BN11 3","Total",4200,2144,2056,4085,115,23,59.90,70.1
"2011","BN11 4","BN11 4","Total",8956,4191,4765,8037,919,80,105.90,84.6
"2011","BN11 5","BN11 5","Total",6428,3044,3384,6325,103,80,124.66,51.6
"2011","BN12 4","BN12 4","Total",7807,3656,4151,7760,47,99,252.24,31.0
"2011","BN12 5","BN12 5","Total",4415,2001,2414,4343,72,41,257.98,17.1
"2011","BN12 6","BN12 6","Total",7905,3764,4141,7905,0,54,378.60,20.9
"2011","BN13 1","BN13 1","Total",8137,3964,4173,8118,19,105,153.75,52.9
"2011","BN13 2","BN13 2","Total",10512,5052,5460,10455,57,73,209.52,50.2
"2011","BN13 3","BN13 3","Total",8887,4297,4590,8774,113,104,1987.85,4.5
"2011","BN14 0","BN14 0","Total",5739,2741,2998,5739,0,67,1869.82,3.1
"2011","BN14 7","BN14 7","Total",10779,5207,5572,10678,101,133,176.48,61.1
"2011","BN14 8","BN14 8","Total",6774,3300,3474,6761,13,60,171.26,39.6
"2011","BN14 9","BN14 9","Total",7444,3638,3806,7399,45,109,588.57,12.6
"2011","BN15 0","BN15 0","Total",8486,4257,4229,8165,321,103,1712.34,5.0
"2011","BN15 8","BN15 8","Total",7801,3684,4117,7672,129,35,281.35,27.7
"2011","BN15 9","BN15 9","Total",11084,5269,5815,11070,14,80,454.93,24.4
"2011","BN16 1","BN16 1","Total",6626,3106,3520,6499,127,73,437.15,15.2
"2011","BN16 2","BN16 2","Total",6920,3206,3714,6835,85,64,256.48,27.0
"2011","BN16 3","BN16 3","Total",8060,3588,4472,7891,169,61,180.03,44.8
"2011","BN16 4","BN16 4","Total",6728,3200,3528,6716,12,71,1658.44,4.1
"2011","BN17 5","BN17 5","Total",6494,3247,3247,6243,251,46,850.97,7.6
"2011","BN17 6","BN17 6","Total",13671,6513,7158,13501,170,122,416.57,32.8
"2011","BN17 7","BN17 7","Total",8127,3964,4163,8099,28,53,368.00,22.1
"2011","BN18 0","BN18 0","Total",8600,4350,4250,7963,637,114,5291.89,1.6
"2011","BN18 9","BN18 9","Total",4868,2330,2538,4813,55,73,5327.52,0.9
"2011","BN2  0","BN2  0","Total",6966,3538,3428,6660,306,53,85.70,81.3
"2011","BN2  1","BN2  1","Total",10122,5634,4488,9984,138,42,80.50,125.7
"2011","BN2  3","BN2  3","Total",12387,6192,6195,12377,10,106,124.19,99.7
"2011","BN2  4","BN2  4","Total",16183,7980,8203,16145,38,98,586.96,27.6
"2011","BN2  5","BN2  5","Total",12830,6322,6508,12520,310,97,557.54,23.0
"2011","BN2  6","BN2  6","Total",9793,4710,5083,9783,10,69,843.38,11.6
"2011","BN2  7","BN2  7","Total",4375,2025,2350,4214,161,68,506.89,8.6
"2011","BN2  8","BN2  8","Total",8561,4138,4423,8481,80,87,422.82,20.2
"2011","BN2  9","BN2  9","Total",11526,5760,5766,11276,250,129,70.66,163.1
"2011","BN20 0","BN20 0","Total",1620,761,859,1601,19,23,860.38,1.9
"2011","BN20 7","BN20 7","Total",5862,2640,3222,5112,750,72,1156.73,5.1
"2011","BN20 8","BN20 8","Total",8331,3910,4421,8225,106,115,836.58,10.0
"2011","BN20 9","BN20 9","Total",5138,2428,2710,5056,82,63,433.40,11.9
"2011","BN21 1","BN21 1","Total",6943,3236,3707,6825,118,98,167.97,41.3
"2011","BN21 2","BN21 2","Total",9050,4301,4749,8492,558,115,327.07,27.7
"2011","BN21 3","BN21 3","Total",5506,2766,2740,5325,181,37,66.23,83.1
"2011","BN21 4","BN21 4","Total",4276,2167,2109,3890,386,28,60.54,70.6
"2011","BN22 0","BN22 0","Total",9479,4496,4983,9479,0,66,298.40,31.8
"2011","BN22 7","BN22 7","Total",4774,2321,2453,4732,42,34,87.38,54.6
"2011","BN22 8","BN22 8","Total",10355,5012,5343,10316,39,75,376.20,27.5
"2011","BN22 9","BN22 9","Total",7638,3596,4042,7497,141,50,244.30,31.3
"2011","BN23 5","BN23 5","Total",6273,3156,3117,6273,0,54,116.86,53.7
"2011","BN23 6","BN23 6","Total",6715,3191,3524,6687,28,48,184.26,36.4
"2011","BN23 7","BN23 7","Total",7246,3418,3828,7238,8,38,215.66,33.6
"2011","BN23 8","BN23 8","Total",8068,3888,4180,8055,13,92,200.05,40.3
"2011","BN24 5","BN24 5","Total",6255,3016,3239,6233,22,68,2918.43,2.1
"2011","BN24 6","BN24 6","Total",3036,1432,1604,3022,14,19,618.92,4.9
"2011","BN25 1","BN25 1","Total",4666,2232,2434,4510,156,38,197.73,23.6
"2011","BN25 2","BN25 2","Total",7255,3505,3750,6999,256,79,563.16,12.9
"2011","BN25 3","BN25 3","Total",8838,4228,4610,8799,39,71,616.69,14.3
"2011","BN25 4","BN25 4","Total",2812,1301,1511,2799,13,34,348.95,8.1
"2011","BN26 5","BN26 5","Total",6296,2942,3354,6142,154,74,5238.94,1.2
"2011","BN26 6","BN26 6","Total",5130,2428,2702,5063,67,46,3459.39,1.5
"2011","BN27 1","BN27 1","Total",6219,2996,3223,6160,59,74,1610.85,3.9
"2011","BN27 2","BN27 2","Total",5172,2408,2764,5127,45,37,882.22,5.9
"2011","BN27 3","BN27 3","Total",10992,5238,5754,10572,420,120,1730.86,6.4
"2011","BN27 4","BN27 4","Total",4459,2138,2321,4259,200,81,4921.16,0.9
"2011","BN3  1","BN3  1","Total",10441,5423,5018,10258,183,77,61.89,168.7
"2011","BN3  2","BN3  2","Total",6869,3595,3274,6745,124,25,57.80,118.8
"2011","BN3  3","BN3  3","Total",12625,6483,6142,12556,69,58,93.18,135.5
"2011","BN3  4","BN3  4","Total",7776,3663,4113,7490,286,109,120.72,64.4
"2011","BN3  5","BN3  5","Total",11938,5690,6248,11643,295,125,122.75,97.3
"2011","BN3  6","BN3  6","Total",11499,5697,5802,11175,324,245,298.95,38.5
"2011","BN3  7","BN3  7","Total",10367,5029,5338,10287,80,142,245.96,42.1
"2011","BN3  8","BN3  8","Total",7998,3763,4235,7998,0,102,581.47,13.8
"2011","BN41 1","BN41 1","Total",6557,3174,3383,6526,31,52,150.67,43.5
"2011","BN41 2","BN41 2","Total",14358,6939,7419,14254,104,117,693.71,20.7
"2011","BN42 4","BN42 4","Total",9991,4827,5164,9920,71,86,701.77,14.2
"2011","BN43 5","BN43 5","Total",11302,5491,5811,11240,62,139,674.34,16.8
"2011","BN43 6","BN43 6","Total",11190,5343,5847,11029,161,98,310.02,36.1
"2011","BN44 3","BN44 3","Total",10125,4782,5343,9972,153,192,4913.51,2.1
"2011","BN45 7","BN45 7","Total",669,343,326,669,0,8,2247.30,0.3
"2011","BN5  9","BN5  9","Total",7106,3338,3768,6974,132,126,4814.61,1.5
"2011","BN6  8","BN6  8","Total",8684,4100,4584,8646,38,161,2786.22,3.1
"2011","BN6  9","BN6  9","Total",8716,4241,4475,8519,197,159,3487.65,2.5
"2011","BN7  1","BN7  1","Total",8670,4253,4417,8352,318,200,437.38,19.8
"2011","BN7  2","BN7  2","Total",8333,4057,4276,8270,63,96,662.43,12.6
"2011","BN7  3","BN7  3","Total",4187,2039,2148,4032,155,160,5805.77,0.7
"2011","BN8  4","BN8  4","Total",5969,2953,3016,5867,102,181,3640.77,1.6
"2011","BN8  5","BN8  5","Total",6121,2921,3200,6052,69,103,4370.44,1.4
"2011","BN8  6","BN8  6","Total",4220,2105,2115,4139,81,100,9757.59,0.4
"2011","BN9  0","BN9  0","Total",3931,1926,2005,3880,51,37,1026.23,3.8
"2011","BN9  9","BN9  9","Total",9546,4783,4763,9528,18,67,920.73,10.4
"2011","BR1  1","BR1  1","Total",475,243,232,475,0,1,17.03,27.9
"2011","BR1  2","BR1  2","Total",11771,5559,6212,11323,448,260,385.24,30.6
"2011","BR1  3","BR1  3","Total",12689,6125,6564,12526,163,166,256.77,49.4
"2011","BR1  4","BR1  4","Total",14203,6619,7584,14014,189,178,278.64,51.0
"2011","BR1  5","BR1  5","Total",17193,8051,9142,17193,0,162,375.74,45.8
"2011","BR2  0","BR2  0","Total",11719,5601,6118,11701,18,179,242.46,48.3
"2011","BR2  6","BR2  6","Total",2332,1139,1193,2326,6,69,853.51,2.7
"2011","BR2  7","BR2  7","Total",9093,4423,4670,9048,45,190,856.42,10.6
"2011","BR2  8","BR2  8","Total",10727,5113,5614,10716,11,139,452.56,23.7
"2011","BR2  9","BR2  9","Total",10969,5385,5584,10963,6,167,268.34,40.9
"2011","BR3  1","BR3  1","Total",8987,4319,4668,8941,46,99,331.80,27.1
"2011","BR3  3","BR3  3","Total",13060,6254,6806,12925,135,287,472.02,27.7
"2011","BR3  4","BR3  4","Total",12874,6190,6684,12835,39,155,211.82,60.8
"2011","BR3  5","BR3  5","Total",6772,3344,3428,6701,71,94,132.01,51.3
"2011","BR3  6","BR3  6","Total",5631,2708,2923,5590,41,173,160.91,35.0
"2011","BR4  0","BR4  0","Total",9058,4427,4631,9032,26,216,266.88,33.9
"2011","BR4  9","BR4  9","Total",9928,4715,5213,9796,132,183,312.00,31.8
"2011","BR5  1","BR5  1","Total",11828,5697,6131,11828,0,213,381.73,31.0
"2011","BR5  2","BR5  2","Total",12838,6079,6759,12788,50,116,294.02,43.7
"2011","BR5  3","BR5  3","Total",10607,4880,5727,10607,0,90,495.64,21.4
"2011","BR5  4","BR5  4","Total",10439,4978,5461,10429,10,75,941.57,11.1
"2011","BR6  0","BR6  0","Total",9444,4580,4864,9402,42,168,242.26,39.0
"2011","BR6  6","BR6  6","Total",6647,3265,3382,6647,0,128,333.94,19.9
"2011","BR6  7","BR6  7","Total",7890,3720,4170,7890,0,124,2303.25,3.4
"2011","BR6  8","BR6  8","Total",8225,3959,4266,8179,46,158,361.38,22.8
"2011","BR6  9","BR6  9","Total",14622,7069,7553,14590,32,222,439.04,33.3
"2011","BR7  5","BR7  5","Total",6610,3186,3424,6533,77,189,475.11,13.9
"2011","BR7  6","BR7  6","Total",10690,5120,5570,10225,465,186,633.98,16.9
"2011","BR8  7","BR8  7","Total",14884,7142,7742,14882,2,161,671.83,22.2
"2011","BR8  8","BR8  8","Total",7088,3475,3613,7087,1,76,945.56,7.5
"2011","BS1  1","BS1  1","Total",1210,681,529,1018,192,10,35.29,34.3
"2011","BS1  2","BS1  2","Total",542,279,263,299,243,14,5.88,92.2
"2011","BS1  3","BS1  3","Total",2366,1238,1128,1437,929,33,23.21,101.9
"2011","BS1  4","BS1  4","Total",529,321,208,495,34,2,11.86,44.6
"2011","BS1  5","BS1  5","Total",3157,1631,1526,3021,136,30,49.80,63.4
"2011","BS1  6","BS1  6","Total",4187,2354,1833,4110,77,29,169.34,24.7
"2011","BS10 5","BS10 5","Total",9500,4564,4936,9415,85,63,173.13,54.9
"2011","BS10 6","BS10 6","Total",10223,4898,5325,10050,173,68,284.71,35.9
"2011","BS10 7","BS10 7","Total",7882,3745,4137,7856,26,45,807.38,9.8
"2011","BS11 0","BS11 0","Total",9574,4598,4976,9528,46,46,1144.60,8.4
"2011","BS11 9","BS11 9","Total",7780,3805,3975,7708,72,53,699.81,11.1
"2011","BS13 0","BS13 0","Total",7542,3549,3993,7531,11,22,231.83,32.5
"2011","BS13 7","BS13 7","Total",8316,4067,4249,8265,51,43,319.81,26.0
"2011","BS13 8","BS13 8","Total",7339,3415,3924,7332,7,30,159.69,46.0
"2011","BS13 9","BS13 9","Total",6388,3038,3350,6320,68,16,145.26,44.0
"2011","BS14 0","BS14 0","Total",8866,4337,4529,8714,152,39,585.59,15.1
"2011","BS14 8","BS14 8","Total",7765,3701,4064,7672,93,34,228.80,33.9
"2011","BS14 9","BS14 9","Total",11524,5623,5901,11481,43,84,254.23,45.3
"2011","BS15 1","BS15 1","Total",11936,5852,6084,11670,266,57,184.56,64.7
"2011","BS15 3","BS15 3","Total",8812,4310,4502,8750,62,85,317.02,27.8
"2011","BS15 4","BS15 4","Total",11104,5371,5733,11082,22,57,246.01,45.1
"2011","BS15 8","BS15 8","Total",7373,3634,3739,7324,49,41,145.58,50.6
"2011","BS15 9","BS15 9","Total",8102,4022,4080,7987,115,39,183.42,44.2
"2011","BS16 1","BS16 1","Total",12172,6134,6038,9669,2503,211,1289.78,9.4
"2011","BS16 2","BS16 2","Total",9075,4383,4692,8925,150,87,245.15,37.0
"2011","BS16 3","BS16 3","Total",6854,3458,3396,6810,44,48,124.15,55.2
"2011","BS16 4","BS16 4","Total",9181,4454,4727,9145,36,44,146.43,62.7
"2011","BS16 5","BS16 5","Total",9998,4870,5128,9870,128,82,177.81,56.2
"2011","BS16 6","BS16 6","Total",10598,5184,5414,10575,23,131,259.47,40.8
"2011","BS16 7","BS16 7","Total",7880,3942,3938,7871,9,127,287.79,27.4
"2011","BS16 9","BS16 9","Total",10150,5104,5046,10026,124,90,1134.30,8.9
"2011","BS2  0","BS2  0","Total",2919,1661,1258,2897,22,9,84.88,34.4
"2011","BS2  8","BS2  8","Total",5953,3218,2735,5809,144,50,61.15,97.4
"2011","BS2  9","BS2  9","Total",6727,3374,3353,6577,150,46,98.68,68.2
"2011","BS20 0","BS20 0","Total",4828,2410,2418,4791,37,54,777.60,6.2
"2011","BS20 6","BS20 6","Total",7966,3879,4087,7934,32,96,407.69,19.5
"2011","BS20 7","BS20 7","Total",11362,5655,5707,11309,53,119,1896.08,6.0
"2011","BS20 8","BS20 8","Total",5847,2845,3002,5807,40,130,606.16,9.6
"2011","BS21 5","BS21 5","Total",4861,2384,2477,4858,3,71,222.75,21.8
"2011","BS21 6","BS21 6","Total",8926,4336,4590,8811,115,110,2915.86,3.1
"2011","BS21 7","BS21 7","Total",9496,4495,5001,9002,494,131,808.36,11.7
"2011","BS22 6","BS22 6","Total",7979,3758,4221,7970,9,65,171.78,46.4
"2011","BS22 7","BS22 7","Total",10339,5085,5254,10339,0,118,849.19,12.2
"2011","BS22 8","BS22 8","Total",10599,5163,5436,10599,0,110,249.29,42.5
"2011","BS22 9","BS22 9","Total",8525,4169,4356,8418,107,94,1163.93,7.3
"2011","BS23 1","BS23 1","Total",4940,2485,2455,4437,503,26,99.22,49.8
"2011","BS23 2","BS23 2","Total",9195,4490,4705,8568,627,72,323.40,28.4
"2011","BS23 3","BS23 3","Total",12214,5988,6226,12076,138,66,293.64,41.6
"2011","BS23 4","BS23 4","Total",7647,3631,4016,7275,372,85,370.50,20.6
"2011","BS24 0","BS24 0","Total",2039,981,1058,2014,25,45,1980.72,1.0
"2011","BS24 6","BS24 6","Total",359,180,179,359,0,11,778.79,0.5
"2011","BS24 7","BS24 7","Total",8306,4019,4287,8242,64,50,485.14,17.1
"2011","BS24 8","BS24 8","Total",2166,1055,1111,2166,0,19,569.23,3.8
"2011","BS24 9","BS24 9","Total",5971,2827,3144,5953,18,57,491.47,12.1
"2011","BS25 1","BS25 1","Total",4616,2242,2374,4398,218,86,1735.65,2.7
"2011","BS25 5","BS25 5","Total",1616,753,863,1506,110,42,1175.47,1.4
"2011","BS26 2","BS26 2","Total",5127,2528,2599,5066,61,124,5388.51,1.0
"2011","BS27 3","BS27 3","Total",7081,3375,3706,6969,112,140,4590.87,1.5
"2011","BS28 4","BS28 4","Total",3318,1633,1685,3318,0,88,4165.37,0.8
"2011","BS29 6","BS29 6","Total",2919,1410,1509,2919,0,37,1726.93,1.7
"2011","BS3  1","BS3  1","Total",8891,4598,4293,8699,192,67,89.40,99.5
"2011","BS3  2","BS3  2","Total",6065,2877,3188,6058,7,34,277.75,21.8
"2011","BS3  3","BS3  3","Total",6157,3048,3109,6132,25,25,56.23,109.5
"2011","BS3  4","BS3  4","Total",7639,3919,3720,7579,60,49,129.05,59.2
"2011","BS3  5","BS3  5","Total",8009,3896,4113,8009,0,57,155.63,51.5
"2011","BS30 5","BS30 5","Total",5040,2446,2594,5026,14,55,2330.00,2.2
"2011","BS30 6","BS30 6","Total",3509,1723,1786,3462,47,67,1165.29,3.0
"2011","BS30 7","BS30 7","Total",3666,1861,1805,3666,0,36,91.60,40.0
"2011","BS30 8","BS30 8","Total",10295,5035,5260,10182,113,72,423.52,24.3
"2011","BS30 9","BS30 9","Total",7850,3882,3968,7787,63,88,384.79,20.4
"2011","BS31 1","BS31 1","Total",7446,3563,3883,7388,58,113,466.09,16.0
"2011","BS31 2","BS31 2","Total",8481,4058,4423,8388,93,84,1436.19,5.9
"2011","BS31 3","BS31 3","Total",4073,1995,2078,4054,19,91,556.02,7.3
"2011","BS32 0","BS32 0","Total",7373,3755,3618,7356,17,71,173.28,42.5
"2011","BS32 4","BS32 4","Total",4380,2118,2262,4292,88,91,3111.06,1.4
"2011","BS32 8","BS32 8","Total",8354,4162,4192,8354,0,105,138.00,60.5
"2011","BS32 9","BS32 9","Total",4651,2361,2290,4650,1,36,111.99,41.5
"2011","BS34 5","BS34 5","Total",8122,4044,4078,8119,3,41,357.38,22.7
"2011","BS34 6","BS34 6","Total",6295,3097,3198,6281,14,44,156.49,40.2
"2011","BS34 7","BS34 7","Total",7057,3608,3449,7002,55,50,321.36,22.0
"2011","BS34 8","BS34 8","Total",8316,4209,4107,8271,45,105,407.30,20.4
"2011","BS35 1","BS35 1","Total",6608,3207,3401,6460,148,152,3964.53,1.7
"2011","BS35 2","BS35 2","Total",6436,3220,3216,6436,0,112,332.12,19.4
"2011","BS35 3","BS35 3","Total",3058,1520,1538,3036,22,49,1280.21,2.4
"2011","BS35 4","BS35 4","Total",4888,2451,2437,4879,9,54,2320.84,2.1
"2011","BS35 5","BS35 5","Total",650,325,325,650,0,12,741.09,0.9
"2011","BS36 1","BS36 1","Total",6242,2995,3247,6161,81,84,411.82,15.2
"2011","BS36 2","BS36 2","Total",9201,4608,4593,9144,57,123,1896.11,4.9
"2011","BS37 4","BS37 4","Total",8102,4009,4093,8030,72,65,227.52,35.6
"2011","BS37 5","BS37 5","Total",7723,3795,3928,7702,21,74,252.73,30.6
"2011","BS37 6","BS37 6","Total",8025,3930,4095,7949,76,109,4978.70,1.6
"2011","BS37 7","BS37 7","Total",6952,3449,3503,6798,154,86,1399.58,5.0
"2011","BS37 8","BS37 8","Total",6452,3186,3266,6434,18,43,541.02,11.9
"2011","BS37 9","BS37 9","Total",807,401,406,805,2,12,1063.94,0.8
"2011","BS39 4","BS39 4","Total",2593,1269,1324,2564,29,40,3461.57,0.7
"2011","BS39 5","BS39 5","Total",4563,2256,2307,4516,47,111,2550.13,1.8
"2011","BS39 6","BS39 6","Total",3005,1478,1527,2937,68,46,842.07,3.6
"2011","BS39 7","BS39 7","Total",5302,2595,2707,5203,99,48,651.23,8.1
"2011","BS4  1","BS4  1","Total",12962,6153,6809,12948,14,77,264.28,49.0
"2011","BS4  2","BS4  2","Total",9948,4982,4966,9872,76,105,165.85,60.0
"2011","BS4  3","BS4  3","Total",8856,4494,4362,8801,55,51,163.42,54.2
"2011","BS4  4","BS4  4","Total",12382,6120,6262,12273,109,80,419.36,29.5
"2011","BS4  5","BS4  5","Total",3811,1859,1952,3771,40,19,195.53,19.5
"2011","BS40 5","BS40 5","Total",4496,2174,2322,4486,10,88,2809.27,1.6
"2011","BS40 6","BS40 6","Total",2249,1103,1146,2246,3,68,5888.37,0.4
"2011","BS40 7","BS40 7","Total",1571,756,815,1571,0,44,1502.47,1.0
"2011","BS40 8","BS40 8","Total",3833,1890,1943,3830,3,106,4182.99,0.9
"2011","BS40 9","BS40 9","Total",637,318,319,637,0,5,155.18,4.1
"2011","BS41 8","BS41 8","Total",829,420,409,829,0,19,982.21,0.8
"2011","BS41 9","BS41 9","Total",5254,2567,2687,5224,30,102,715.07,7.3
"2011","BS48 1","BS48 1","Total",5537,2680,2857,5431,106,111,2410.25,2.3
"2011","BS48 2","BS48 2","Total",6848,3289,3559,6848,0,118,215.61,31.8
"2011","BS48 3","BS48 3","Total",5537,2692,2845,5503,34,159,2810.93,2.0
"2011","BS48 4","BS48 4","Total",5486,2692,2794,5486,0,123,885.99,6.2
"2011","BS49 4","BS49 4","Total",8454,4162,4292,8362,92,145,1930.05,4.4
"2011","BS49 5","BS49 5","Total",3497,1602,1895,3444,53,67,1550.66,2.3
"2011","BS5  0","BS5  0","Total",8743,4578,4165,8711,32,51,113.05,77.3
"2011","BS5  6","BS5  6","Total",13181,6646,6535,13145,36,98,223.68,58.9
"2011","BS5  7","BS5  7","Total",10919,5275,5644,10840,79,56,214.04,51.0
"2011","BS5  8","BS5  8","Total",9587,4759,4828,9465,122,45,208.15,46.1
"2011","BS5  9","BS5  9","Total",9913,5053,4860,9868,45,44,176.09,56.3
"2011","BS6  5","BS6  5","Total",10728,5663,5065,10576,152,145,94.53,113.5
"2011","BS6  6","BS6  6","Total",12944,6663,6281,12764,180,196,123.31,105.0
"2011","BS6  7","BS6  7","Total",10009,5078,4931,9811,198,230,162.31,61.7
"2011","BS7  0","BS7  0","Total",15411,7893,7518,15307,104,134,286.56,53.8
"2011","BS7  8","BS7  8","Total",10257,5227,5030,9906,351,173,138.94,73.8
"2011","BS7  9","BS7  9","Total",15265,7675,7590,15166,99,169,401.98,38.0
"2011","BS8  1","BS8  1","Total",4869,2602,2267,4179,690,39,59.75,81.5
"2011","BS8  2","BS8  2","Total",7248,3728,3520,7196,52,104,70.53,102.8
"2011","BS8  3","BS8  3","Total",5193,2693,2500,4802,391,119,1215.45,4.3
"2011","BS8  4","BS8  4","Total",8792,4573,4219,8525,267,121,115.23,76.3
"2011","BS9  1","BS9  1","Total",8381,4114,4267,6373,2008,237,420.10,20.0
"2011","BS9  2","BS9  2","Total",6600,3162,3438,6600,0,105,313.17,21.1
"2011","BS9  3","BS9  3","Total",8540,3944,4596,8080,460,189,293.23,29.1
"2011","BS9  4","BS9  4","Total",7432,3522,3910,7375,57,163,153.31,48.5
"2011","CA1  1","CA1  1","Total",2218,1176,1042,2132,86,53,95.40,23.2
"2011","CA1  2","CA1  2","Total",11104,5384,5720,10914,190,92,406.69,27.3
"2011","CA1  3","CA1  3","Total",10938,5312,5626,10858,80,62,424.82,25.7
"2011","CA10 1","CA10 1","Total",5757,2884,2873,5743,14,119,26775.79,0.2
"2011","CA10 2","CA10 2","Total",3286,1641,1645,3194,92,56,26884.92,0.1
"2011","CA10 3","CA10 3","Total",4580,2285,2295,4555,25,80,23606.39,0.2
"2011","CA11 0","CA11 0","Total",4416,2210,2206,4125,291,84,28472.80,0.2
"2011","CA11 7","CA11 7","Total",3561,1763,1798,3542,19,68,87.34,40.8
"2011","CA11 8","CA11 8","Total",7907,3754,4153,7677,230,82,3953.55,2.0
"2011","CA11 9","CA11 9","Total",6475,3267,3208,6432,43,114,11197.50,0.6
"2011","CA12 4","CA12 4","Total",4758,2320,2438,4510,248,79,15557.85,0.3
"2011","CA12 5","CA12 5","Total",3268,1623,1645,3010,258,47,13050.44,0.3
"2011","CA13 0","CA13 0","Total",8597,4243,4354,8516,81,183,13933.75,0.6
"2011","CA13 9","CA13 9","Total",6409,3128,3281,6333,76,128,11308.69,0.6
"2011","CA14 1","CA14 1","Total",8434,4153,4281,8407,27,92,2819.28,3.0
"2011","CA14 2","CA14 2","Total",5050,2564,2486,5050,0,41,172.69,29.2
"2011","CA14 3","CA14 3","Total",8500,4093,4407,8380,120,55,233.90,36.3
"2011","CA14 4","CA14 4","Total",6518,3243,3275,6332,186,105,7023.18,0.9
"2011","CA14 5","CA14 5","Total",7297,3539,3758,7245,52,36,855.22,8.5
"2011","CA15 6","CA15 6","Total",4469,2221,2248,4409,60,54,4130.53,1.1
"2011","CA15 7","CA15 7","Total",6771,3329,3442,6727,44,74,1657.16,4.1
"2011","CA15 8","CA15 8","Total",4978,2442,2536,4927,51,29,1003.69,5.0
"2011","CA16 6","CA16 6","Total",6175,3054,3121,6054,121,116,28510.65,0.2
"2011","CA17 4","CA17 4","Total",4873,2421,2452,4819,54,79,32419.63,0.2
"2011","CA18 1","CA18 1","Total",328,167,161,318,10,8,2935.47,0.1
"2011","CA19 1","CA19 1","Total",1069,554,515,1049,20,20,12548.00,0.1
"2011","CA2  4","CA2  4","Total",10325,5018,5307,10254,71,63,1171.84,8.8
"2011","CA2  5","CA2  5","Total",7578,3779,3799,7491,87,51,299.73,25.3
"2011","CA2  6","CA2  6","Total",9233,4461,4772,9167,66,56,783.46,11.8
"2011","CA2  7","CA2  7","Total",12299,5918,6381,12074,225,82,308.62,39.9
"2011","CA20 1","CA20 1","Total",3355,1708,1647,3297,58,50,11383.91,0.3
"2011","CA21 2","CA21 2","Total",1017,526,491,1016,1,26,1095.08,0.9
"2011","CA22 2","CA22 2","Total",8887,4380,4507,8849,38,79,3840.21,2.3
"2011","CA23 3","CA23 3","Total",1424,738,686,1417,7,23,9548.22,0.1
"2011","CA24 3","CA24 3","Total",1266,664,602,1266,0,20,384.32,3.3
"2011","CA25 5","CA25 5","Total",6183,3091,3092,6122,61,52,1120.27,5.5
"2011","CA26 3","CA26 3","Total",3868,1903,1965,3867,1,32,2980.78,1.3
"2011","CA27 0","CA27 0","Total",1644,854,790,1561,83,59,741.00,2.2
"2011","CA28 6","CA28 6","Total",9888,4969,4919,9830,58,139,1098.39,9.0
"2011","CA28 7","CA28 7","Total",2798,1464,1334,2729,69,22,113.20,24.7
"2011","CA28 8","CA28 8","Total",8811,4309,4502,8645,166,93,993.89,8.9
"2011","CA28 9","CA28 9","Total",7095,3500,3595,7051,44,50,992.43,7.1
"2011","CA3  0","CA3  0","Total",6066,2932,3134,6066,0,88,664.83,9.1
"2011","CA3  8","CA3  8","Total",331,195,136,270,61,5,80.46,4.1
"2011","CA3  9","CA3  9","Total",7618,3626,3992,7488,130,106,349.29,21.8
"2011","CA4  0","CA4  0","Total",3198,1589,1609,3154,44,54,10990.86,0.3
"2011","CA4  8","CA4  8","Total",5631,2687,2944,5582,49,132,3119.65,1.8
"2011","CA4  9","CA4  9","Total",850,428,422,842,8,17,5099.79,0.2
"2011","CA5  6","CA5  6","Total",3815,1898,1917,3809,6,62,8400.70,0.5
"2011","CA5  7","CA5  7","Total",3299,1622,1677,3196,103,60,9945.28,0.3
"2011","CA6  4","CA6  4","Total",4197,2097,2100,4148,49,72,12022.33,0.3
"2011","CA6  5","CA6  5","Total",3336,1707,1629,3269,67,26,13059.82,0.3
"2011","CA6  6","CA6  6","Total",1561,775,786,1561,0,22,19744.11,0.1
"2011","CA7  0","CA7  0","Total",1710,873,837,1697,13,34,9123.39,0.2
"2011","CA7  1","CA7  1","Total",1448,714,734,1444,4,16,9068.08,0.2
"2011","CA7  2","CA7  2","Total",2690,1347,1343,2688,2,31,6065.31,0.4
"2011","CA7  3","CA7  3","Total",2941,1460,1481,2921,20,22,3423.34,0.9
"2011","CA7  4","CA7  4","Total",4087,1936,2151,3976,111,33,5565.87,0.7
"2011","CA7  5","CA7  5","Total",1933,963,970,1932,1,35,8012.12,0.2
"2011","CA7  8","CA7  8","Total",1893,945,948,1846,47,33,11497.04,0.2
"2011","CA7  9","CA7  9","Total",5831,2785,3046,5743,88,62,461.82,12.6
"2011","CA8  1","CA8  1","Total",4745,2274,2471,4683,62,45,2817.28,1.7
"2011","CA8  2","CA8  2","Total",1912,979,933,1885,27,39,22298.61,0.1
"2011","CA8  7","CA8  7","Total",1431,716,715,1425,6,19,17733.43,0.1
"2011","CA8  9","CA8  9","Total",2226,1133,1093,2221,5,62,9910.29,0.2
"2011","CA9  3","CA9  3","Total",2088,1013,1075,2060,28,47,14948.78,0.1
"2011","CB1  1","CB1  1","Total",3643,1871,1772,3230,413,45,68.90,52.9
"2011","CB1  2","CB1  2","Total",7603,3938,3665,7044,559,149,102.52,74.2
"2011","CB1  3","CB1  3","Total",18497,9330,9167,18367,130,184,410.38,45.1
"2011","CB1  7","CB1  7","Total",4396,2157,2239,4340,56,128,103.59,42.4
"2011","CB1  8","CB1  8","Total",5656,2722,2934,5567,89,121,177.16,31.9
"2011","CB1  9","CB1  9","Total",9443,4678,4765,9395,48,145,1015.61,9.3
"2011","CB10 1","CB10 1","Total",4610,2251,2359,4603,7,123,4743.01,1.0
"2011","CB10 2","CB10 2","Total",8887,4489,4398,8641,246,243,9759.32,0.9
"2011","CB11 3","CB11 3","Total",9635,4712,4923,9464,171,208,4951.56,1.9
"2011","CB11 4","CB11 4","Total",8412,4152,4260,8364,48,218,7721.77,1.1
"2011","CB2  0","CB2  0","Total",1173,531,642,943,230,36,177.14,6.6
"2011","CB2  1","CB2  1","Total",7559,4206,3353,1970,5589,149,138.97,54.4
"2011","CB2  3","CB2  3","Total",2283,1302,981,299,1984,38,38.31,59.6
"2011","CB2  7","CB2  7","Total",495,227,268,139,356,9,37.99,13.0
"2011","CB2  8","CB2  8","Total",3875,1956,1919,3011,864,115,295.23,13.1
"2011","CB2  9","CB2  9","Total",3153,1555,1598,3152,1,60,411.12,7.7
"2011","CB21 4","CB21 4","Total",8505,4141,4364,8417,88,195,8515.58,1.0
"2011","CB21 5","CB21 5","Total",5556,2738,2818,5467,89,121,6561.15,0.8
"2011","CB21 6","CB21 6","Total",1565,762,803,1565,0,44,1778.47,0.9
"2011","CB22 3","CB22 3","Total",7765,3825,3940,7726,39,119,2396.46,3.2
"2011","CB22 4","CB22 4","Total",4311,2142,2169,4310,1,116,2197.54,2.0
"2011","CB22 5","CB22 5","Total",7617,3726,3891,7602,15,172,2315.00,3.3
"2011","CB22 6","CB22 6","Total",1232,617,615,1232,0,33,711.09,1.7
"2011","CB22 7","CB22 7","Total",3100,1528,1572,3100,0,65,2031.05,1.5
"2011","CB23 1","CB23 1","Total",2656,1317,1339,2656,0,73,2589.56,1.0
"2011","CB23 2","CB23 2","Total",1961,970,991,1959,2,52,3170.99,0.6
"2011","CB23 3","CB23 3","Total",3452,1676,1776,3436,16,46,1108.09,3.1
"2011","CB23 4","CB23 4","Total",1081,533,548,1079,2,38,3720.96,0.3
"2011","CB23 5","CB23 5","Total",2337,1173,1164,2337,0,44,99.67,23.4
"2011","CB23 6","CB23 6","Total",5849,2909,2940,5849,0,46,578.94,10.1
"2011","CB23 7","CB23 7","Total",8509,4174,4335,8509,0,202,3333.75,2.6
"2011","CB23 8","CB23 8","Total",5040,2523,2517,5034,6,89,2272.33,2.2
"2011","CB24 3","CB24 3","Total",4184,2102,2082,4183,1,59,2010.02,2.1
"2011","CB24 4","CB24 4","Total",3319,1678,1641,3319,0,58,2213.95,1.5
"2011","CB24 5","CB24 5","Total",6877,3402,3475,6875,2,128,3389.94,2.0
"2011","CB24 6","CB24 6","Total",4251,2142,2109,4221,30,75,720.36,5.9
"2011","CB24 8","CB24 8","Total",6543,3181,3362,6457,86,122,3480.94,1.9
"2011","CB24 9","CB24 9","Total",7866,3834,4032,7714,152,164,1305.11,6.0
"2011","CB25 0","CB25 0","Total",8216,4004,4212,8193,23,135,5824.72,1.4
"2011","CB25 9","CB25 9","Total",10048,5171,4877,9366,682,150,7115.47,1.4
"2011","CB3  0","CB3  0","Total",8737,4407,4330,6753,1984,195,1141.40,7.7
"2011","CB3  9","CB3  9","Total",7533,3761,3772,3570,3963,172,738.35,10.2
"2011","CB4  1","CB4  1","Total",15887,8081,7806,15479,408,208,433.01,36.7
"2011","CB4  2","CB4  2","Total",14379,7235,7144,14171,208,177,249.77,57.6
"2011","CB4  3","CB4  3","Total",11632,5918,5714,11462,170,186,318.10,36.6
"2011","CB5  8","CB5  8","Total",11036,5661,5375,11010,26,124,1023.73,10.8
"2011","CB6  1","CB6  1","Total",12422,6099,6323,12251,171,116,5565.54,2.2
"2011","CB6  2","CB6  2","Total",11941,5925,6016,11895,46,156,11401.72,1.0
"2011","CB6  3","CB6  3","Total",14012,6972,7040,13980,32,151,8719.70,1.6
"2011","CB7  4","CB7  4","Total",8619,4255,4364,8365,254,116,5554.41,1.6
"2011","CB7  5","CB7  5","Total",17997,8984,9013,17955,42,216,15987.86,1.1
"2011","CB8  0","CB8  0","Total",9676,4732,4944,9559,117,86,2722.46,3.6
"2011","CB8  7","CB8  7","Total",6488,3266,3222,6426,62,83,3269.61,2.0
"2011","CB8  8","CB8  8","Total",9159,4567,4592,9129,30,121,7821.17,1.2
"2011","CB8  9","CB8  9","Total",7918,4523,3395,6755,1163,137,13182.30,0.6
"2011","CB9  0","CB9  0","Total",8371,4184,4187,8367,4,51,224.03,37.4
"2011","CB9  7","CB9  7","Total",9770,4797,4973,9648,122,147,7915.51,1.2
"2011","CB9  8","CB9  8","Total",6076,3036,3040,6043,33,37,274.33,22.1
"2011","CB9  9","CB9  9","Total",8654,4298,4356,8608,46,65,499.61,17.3
"2011","CH1  1","CH1  1","Total",900,476,424,853,47,12,42.95,21.0
"2011","CH1  2","CH1  2","Total",949,487,462,939,10,8,85.76,11.1
"2011","CH1  3","CH1  3","Total",3633,1949,1684,3581,52,20,49.89,72.8
"2011","CH1  4","CH1  4","Total",6733,3028,3705,6357,376,87,309.62,21.7
"2011","CH1  5","CH1  5","Total",13407,6442,6965,13311,96,96,310.41,43.2
"2011","CH1  6","CH1  6","Total",4938,2395,2543,4881,57,80,4120.70,1.2
"2011","CH2  1","CH2  1","Total",9382,4476,4906,9103,279,147,523.12,17.9
"2011","CH2  2","CH2  2","Total",7705,3715,3990,7609,96,135,155.23,49.6
"2011","CH2  3","CH2  3","Total",9639,4751,4888,9426,213,133,181.59,53.1
"2011","CH2  4","CH2  4","Total",7595,3722,3873,7414,181,130,3868.37,2.0
"2011","CH3  5","CH3  5","Total",12255,5966,6289,12249,6,210,391.85,31.3
"2011","CH3  6","CH3  6","Total",4832,2368,2464,4832,0,81,3852.52,1.3
"2011","CH3  7","CH3  7","Total",6872,3346,3526,6755,117,167,3619.50,1.9
"2011","CH3  8","CH3  8","Total",3991,1927,2064,3991,0,71,1856.34,2.1
"2011","CH3  9","CH3  9","Total",4060,1967,2093,4060,0,97,7288.09,0.6
"2011","CH4  0","CH4  0","Total",10233,5097,5136,10233,0,97,1356.60,7.5
"2011","CH4  7","CH4  7","Total",7050,3346,3704,7047,3,119,390.25,18.1
"2011","CH4  8","CH4  8","Total",11474,5671,5803,11425,49,131,423.36,27.1
"2011","CH4  9","CH4  9","Total",3540,1734,1806,3540,0,72,4288.46,0.8
"2011","CH41 0","CH41 0","Total",3637,1748,1889,3625,12,28,69.21,52.6
"2011","CH41 1","CH41 1","Total",526,296,230,494,32,1,63.38,8.3
"2011","CH41 2","CH41 2","Total",2943,1510,1433,2875,68,10,48.52,60.7
"2011","CH41 3","CH41 3","Total",1286,625,661,1286,0,3,45.61,28.2
"2011","CH41 4","CH41 4","Total",2994,1379,1615,2994,0,12,103.96,28.8
"2011","CH41 5","CH41 5","Total",738,396,342,736,2,2,43.63,16.9
"2011","CH41 6","CH41 6","Total",147,88,59,147,0,0,5.39,27.3
"2011","CH41 7","CH41 7","Total",2241,1024,1217,2217,24,12,163.69,13.7
"2011","CH41 8","CH41 8","Total",2528,1233,1295,2528,0,10,119.75,21.1
"2011","CH41 9","CH41 9","Total",1627,765,862,1627,0,15,92.95,17.5
"2011","CH42 0","CH42 0","Total",2712,1306,1406,2712,0,15,28.36,95.6
"2011","CH42 1","CH42 1","Total",3342,1643,1699,3269,73,9,80.57,41.5
"2011","CH42 2","CH42 2","Total",2209,1075,1134,2157,52,17,42.09,52.5
"2011","CH42 3","CH42 3","Total",2641,1232,1409,2636,5,14,68.24,38.7
"2011","CH42 4","CH42 4","Total",3930,1917,2013,3851,79,30,75.35,52.2
"2011","CH42 5","CH42 5","Total",3073,1447,1626,3073,0,14,43.55,70.6
"2011","CH42 6","CH42 6","Total",4402,2067,2335,4366,36,40,80.12,54.9
"2011","CH42 7","CH42 7","Total",2307,1139,1168,2263,44,7,26.61,86.7
"2011","CH42 8","CH42 8","Total",2521,1191,1330,2466,55,53,93.61,26.9
"2011","CH42 9","CH42 9","Total",3919,1917,2002,3891,28,26,47.33,82.8
"2011","CH43 0","CH43 0","Total",5411,2652,2759,5411,0,53,113.40,47.7
"2011","CH43 1","CH43 1","Total",2750,1375,1375,2598,152,35,54.63,50.3
"2011","CH43 2","CH43 2","Total",4378,2185,2193,4357,21,50,110.19,39.7
"2011","CH43 3","CH43 3","Total",2596,1238,1358,2596,0,23,142.27,18.2
"2011","CH43 4","CH43 4","Total",2866,1450,1416,2681,185,19,77.77,36.9
"2011","CH43 5","CH43 5","Total",3573,1752,1821,3568,5,45,73.37,48.7
"2011","CH43 6","CH43 6","Total",1718,792,926,1556,162,20,56.29,30.5
"2011","CH43 7","CH43 7","Total",5742,2655,3087,5686,56,44,170.65,33.6
"2011","CH43 8","CH43 8","Total",1730,868,862,1709,21,23,62.46,27.7
"2011","CH43 9","CH43 9","Total",8152,3820,4332,8078,74,65,325.47,25.0
"2011","CH44 0","CH44 0","Total",3111,1543,1568,3069,42,22,35.11,88.6
"2011","CH44 1","CH44 1","Total",2764,1356,1408,2733,31,24,29.46,93.8
"2011","CH44 2","CH44 2","Total",2766,1347,1419,2754,12,31,55.96,49.4
"2011","CH44 3","CH44 3","Total",2470,1195,1275,2446,24,24,42.06,58.7
"2011","CH44 4","CH44 4","Total",4346,2102,2244,4346,0,22,137.28,31.7
"2011","CH44 5","CH44 5","Total",3069,1514,1555,3004,65,23,46.42,66.1
"2011","CH44 6","CH44 6","Total",2581,1263,1318,2581,0,10,34.44,74.9
"2011","CH44 7","CH44 7","Total",1807,859,948,1807,0,8,62.41,29.0
"2011","CH44 8","CH44 8","Total",3180,1587,1593,3101,79,12,34.40,92.4
"2011","CH44 9","CH44 9","Total",3820,1886,1934,3777,43,21,45.42,84.1
"2011","CH45 0","CH45 0","Total",1675,811,864,1642,33,29,55.68,30.1
"2011","CH45 1","CH45 1","Total",2787,1353,1434,2787,0,28,50.52,55.2
"2011","CH45 2","CH45 2","Total",2531,1257,1274,2498,33,20,57.38,44.1
"2011","CH45 3","CH45 3","Total",2549,1225,1324,2549,0,36,69.18,36.8
"2011","CH45 4","CH45 4","Total",3881,1834,2047,3881,0,31,63.22,61.4
"2011","CH45 5","CH45 5","Total",4846,2352,2494,4815,31,53,60.61,80.0
"2011","CH45 6","CH45 6","Total",2509,1217,1292,2509,0,67,41.27,60.8
"2011","CH45 7","CH45 7","Total",3467,1651,1816,3276,191,30,45.73,75.8
"2011","CH45 8","CH45 8","Total",4498,2177,2321,4495,3,47,224.05,20.1
"2011","CH45 9","CH45 9","Total",2112,1061,1051,2076,36,16,32.06,65.9
"2011","CH46 0","CH46 0","Total",3699,1801,1898,3689,10,33,82.46,44.9
"2011","CH46 1","CH46 1","Total",2755,1299,1456,2755,0,23,130.52,21.1
"2011","CH46 2","CH46 2","Total",2699,1264,1435,2699,0,18,152.15,17.7
"2011","CH46 3","CH46 3","Total",1835,906,929,1835,0,16,97.65,18.8
"2011","CH46 5","CH46 5","Total",523,249,274,522,1,4,47.80,10.9
"2011","CH46 6","CH46 6","Total",5372,2593,2779,5329,43,52,271.81,19.8
"2011","CH46 7","CH46 7","Total",2665,1293,1372,2628,37,10,81.86,32.6
"2011","CH46 8","CH46 8","Total",3033,1446,1587,3033,0,15,89.48,33.9
"2011","CH46 9","CH46 9","Total",2899,1392,1507,2896,3,12,109.42,26.5
"2011","CH47 0","CH47 0","Total",628,302,326,616,12,14,10.20,61.6
"2011","CH47 1","CH47 1","Total",665,309,356,607,58,19,55.26,12.0
"2011","CH47 2","CH47 2","Total",2103,1019,1084,2026,77,25,28.75,73.1
"2011","CH47 3","CH47 3","Total",2305,1097,1208,2252,53,43,66.14,34.9
"2011","CH47 4","CH47 4","Total",933,438,495,933,0,22,140.62,6.6
"2011","CH47 5","CH47 5","Total",788,382,406,721,67,22,20.64,38.2
"2011","CH47 6","CH47 6","Total",916,426,490,916,0,23,32.81,27.9
"2011","CH47 7","CH47 7","Total",1244,606,638,1244,0,18,62.64,19.9
"2011","CH47 9","CH47 9","Total",1327,617,710,1327,0,38,403.70,3.3
"2011","CH48 0","CH48 0","Total",1764,835,929,1764,0,28,61.35,28.8
"2011","CH48 1","CH48 1","Total",899,425,474,899,0,30,271.04,3.3
"2011","CH48 2","CH48 2","Total",1367,670,697,1330,37,45,208.84,6.5
"2011","CH48 3","CH48 3","Total",1381,621,760,1381,0,29,31.86,43.3
"2011","CH48 4","CH48 4","Total",812,383,429,789,23,17,21.89,37.1
"2011","CH48 5","CH48 5","Total",2694,1248,1446,2584,110,47,265.70,10.1
"2011","CH48 6","CH48 6","Total",2089,981,1108,2086,3,37,66.48,31.4
"2011","CH48 7","CH48 7","Total",617,315,302,617,0,17,24.57,25.1
"2011","CH48 8","CH48 8","Total",1301,651,650,1301,0,52,84.01,15.5
"2011","CH48 9","CH48 9","Total",2282,1108,1174,2282,0,50,166.79,13.7
"2011","CH49 0","CH49 0","Total",1747,846,901,1747,0,30,84.28,20.7
"2011","CH49 1","CH49 1","Total",2453,1189,1264,2453,0,49,70.68,34.7
"2011","CH49 2","CH49 2","Total",3664,1740,1924,3664,0,51,116.61,31.4
"2011","CH49 3","CH49 3","Total",3294,1571,1723,3239,55,66,226.37,14.6
"2011","CH49 4","CH49 4","Total",5099,2350,2749,5040,59,44,130.69,39.0
"2011","CH49 5","CH49 5","Total",1557,772,785,1471,86,17,85.28,18.3
"2011","CH49 6","CH49 6","Total",4085,1947,2138,4028,57,89,126.02,32.4
"2011","CH49 7","CH49 7","Total",2287,1046,1241,2287,0,10,49.90,45.8
"2011","CH49 8","CH49 8","Total",2699,1256,1443,2699,0,13,60.27,44.8
"2011","CH49 9","CH49 9","Total",1892,852,1040,1846,46,11,47.17,40.1
"2011","CH5  1","CH5  1","Total",8576,4265,4311,8535,41,47,407.78,21.0
"2011","CH5  2","CH5  2","Total",7286,3687,3599,7286,0,54,1911.16,3.8
"2011","CH5  3","CH5  3","Total",9889,4833,5056,9821,68,161,1996.83,5.0
"2011","CH5  4","CH5  4","Total",16774,8303,8471,16740,34,137,1875.78,8.9
"2011","CH6  5","CH6  5","Total",13187,6483,6704,13050,137,129,2047.24,6.4
"2011","CH6  6","CH6  6","Total",3931,1942,1989,3918,13,39,803.68,4.9
"2011","CH60 0","CH60 0","Total",1280,591,689,1262,18,33,61.36,20.9
"2011","CH60 1","CH60 1","Total",1892,904,988,1892,0,38,67.11,28.2
"2011","CH60 2","CH60 2","Total",1510,746,764,1510,0,46,79.51,19.0
"2011","CH60 3","CH60 3","Total",1018,514,504,1018,0,37,96.98,10.5
"2011","CH60 4","CH60 4","Total",790,372,418,784,6,29,121.95,6.5
"2011","CH60 5","CH60 5","Total",1928,921,1007,1914,14,41,68.73,28.1
"2011","CH60 6","CH60 6","Total",1267,603,664,1259,8,43,127.55,9.9
"2011","CH60 7","CH60 7","Total",1215,550,665,1215,0,16,32.29,37.6
"2011","CH60 8","CH60 8","Total",970,478,492,970,0,33,349.63,2.8
"2011","CH60 9","CH60 9","Total",1214,581,633,1201,13,29,183.48,6.6
"2011","CH61 0","CH61 0","Total",498,241,257,498,0,17,402.76,1.2
"2011","CH61 1","CH61 1","Total",1220,583,637,1204,16,31,563.74,2.2
"2011","CH61 2","CH61 2","Total",619,294,325,619,0,13,65.62,9.4
"2011","CH61 3","CH61 3","Total",1576,734,842,1576,0,19,64.01,24.6
"2011","CH61 4","CH61 4","Total",2867,1392,1475,2867,0,61,251.90,11.4
"2011","CH61 5","CH61 5","Total",2599,1215,1384,2599,0,45,53.31,48.8
"2011","CH61 6","CH61 6","Total",2406,1114,1292,2359,47,36,105.56,22.8
"2011","CH61 7","CH61 7","Total",1923,920,1003,1923,0,22,122.71,15.7
"2011","CH61 8","CH61 8","Total",2154,1014,1140,2154,0,28,68.49,31.4
"2011","CH61 9","CH61 9","Total",1728,855,873,1695,33,37,94.04,18.4
"2011","CH62 0","CH62 0","Total",1094,539,555,1094,0,14,202.26,5.4
"2011","CH62 1","CH62 1","Total",3131,1583,1548,3131,0,16,79.19,39.5
"2011","CH62 2","CH62 2","Total",3535,1709,1826,3421,114,38,164.91,21.4
"2011","CH62 3","CH62 3","Total",1162,570,592,1162,0,6,48.00,24.2
"2011","CH62 4","CH62 4","Total",1890,916,974,1866,24,8,224.48,8.4
"2011","CH62 5","CH62 5","Total",2331,1077,1254,2266,65,15,76.11,30.6
"2011","CH62 6","CH62 6","Total",3919,1926,1993,3911,8,59,124.31,31.5
"2011","CH62 7","CH62 7","Total",3453,1650,1803,3453,0,38,197.47,17.5
"2011","CH62 8","CH62 8","Total",4862,2363,2499,4860,2,29,132.83,36.6
"2011","CH62 9","CH62 9","Total",3355,1580,1775,3355,0,21,289.05,11.6
"2011","CH63 0","CH63 0","Total",4629,2317,2312,4584,45,74,208.78,22.2
"2011","CH63 1","CH63 1","Total",307,141,166,307,0,1,59.19,5.2
"2011","CH63 2","CH63 2","Total",5002,2403,2599,4947,55,58,126.45,39.6
"2011","CH63 3","CH63 3","Total",4382,2063,2319,4272,110,67,88.83,49.3
"2011","CH63 4","CH63 4","Total",328,163,165,328,0,8,1047.05,0.3
"2011","CH63 5","CH63 5","Total",4120,1981,2139,4107,13,69,110.00,37.5
"2011","CH63 6","CH63 6","Total",533,239,294,455,78,6,1211.22,0.4
"2011","CH63 7","CH63 7","Total",3936,1834,2102,3936,0,37,116.94,33.7
"2011","CH63 8","CH63 8","Total",2977,1451,1526,2977,0,35,71.29,41.8
"2011","CH63 9","CH63 9","Total",4383,2100,2283,4299,84,61,311.06,14.1
"2011","CH64 0","CH64 0","Total",2874,1371,1503,2863,11,67,189.04,15.2
"2011","CH64 1","CH64 1","Total",1428,712,716,1410,18,45,450.15,3.2
"2011","CH64 2","CH64 2","Total",1197,558,639,1197,0,28,129.37,9.3
"2011","CH64 3","CH64 3","Total",1997,960,1037,1997,0,25,220.06,9.1
"2011","CH64 4","CH64 4","Total",2756,1355,1401,2756,0,46,890.27,3.1
"2011","CH64 5","CH64 5","Total",922,426,496,871,51,27,1162.57,0.8
"2011","CH64 6","CH64 6","Total",2928,1374,1554,2890,38,59,609.48,4.8
"2011","CH64 7","CH64 7","Total",292,147,145,292,0,1,221.25,1.3
"2011","CH64 8","CH64 8","Total",153,76,77,153,0,2,278.25,0.5
"2011","CH64 9","CH64 9","Total",4374,2115,2259,4349,25,39,292.24,15.0
"2011","CH65 0","CH65 0","Total",1176,567,609,1160,16,4,48.38,24.3
"2011","CH65 2","CH65 2","Total",2588,1309,1279,2579,9,14,73.30,35.3
"2011","CH65 3","CH65 3","Total",1138,591,547,1138,0,7,61.15,18.6
"2011","CH65 4","CH65 4","Total",878,430,448,878,0,5,420.14,2.1
"2011","CH65 5","CH65 5","Total",3385,1672,1713,3385,0,13,1794.23,1.9
"2011","CH65 6","CH65 6","Total",3195,1593,1602,3183,12,29,83.28,38.4
"2011","CH65 7","CH65 7","Total",3659,1761,1898,3625,34,24,83.39,43.9
"2011","CH65 8","CH65 8","Total",4688,2194,2494,4591,97,22,95.72,49.0
"2011","CH65 9","CH65 9","Total",5664,2768,2896,5590,74,45,265.53,21.3
"2011","CH66 1","CH66 1","Total",6055,2891,3164,5976,79,50,307.86,19.7
"2011","CH66 2","CH66 2","Total",12803,6353,6450,12762,41,155,283.21,45.2
"2011","CH66 3","CH66 3","Total",6076,2853,3223,6031,45,26,134.38,45.2
"2011","CH66 4","CH66 4","Total",8583,4246,4337,8583,0,118,339.77,25.3
"2011","CH66 5","CH66 5","Total",1004,471,533,979,25,21,199.41,5.0
"2011","CH66 6","CH66 6","Total",385,190,195,376,9,10,157.39,2.4
"2011","CH66 7","CH66 7","Total",186,100,86,186,0,6,490.00,0.4
"2011","CH7  1","CH7  1","Total",10058,4880,5178,9986,72,147,638.03,15.8
"2011","CH7  2","CH7  2","Total",9549,4667,4882,9460,89,86,310.75,30.7
"2011","CH7  3","CH7  3","Total",6249,3103,3146,6223,26,58,699.13,8.9
"2011","CH7  4","CH7  4","Total",6061,3024,3037,6033,28,82,6872.67,0.9
"2011","CH7  5","CH7  5","Total",6640,3276,3364,6522,118,136,8107.24,0.8
"2011","CH7  6","CH7  6","Total",11509,5604,5905,11465,44,183,3757.67,3.1
"2011","CH8  7","CH8  7","Total",9138,4523,4615,9055,83,77,972.06,9.4
"2011","CH8  8","CH8  8","Total",6200,3133,3067,6188,12,87,6442.15,1.0
"2011","CH8  9","CH8  9","Total",5341,2634,2707,5310,31,44,3609.03,1.5
"2011","CM0  7","CM0  7","Total",8332,4173,4159,8225,107,71,10445.40,0.8
"2011","CM0  8","CM0  8","Total",7671,3806,3865,7659,12,99,2164.56,3.5
"2011","CM1  1","CM1  1","Total",3582,1794,1788,3220,362,39,153.50,23.3
"2011","CM1  2","CM1  2","Total",15985,7838,8147,15794,191,207,377.13,42.4
"2011","CM1  3","CM1  3","Total",8527,4137,4390,8220,307,104,3313.36,2.6
"2011","CM1  4","CM1  4","Total",13114,6363,6751,13088,26,224,6256.59,2.1
"2011","CM1  6","CM1  6","Total",13344,6609,6735,13277,67,205,453.48,29.4
"2011","CM1  7","CM1  7","Total",8310,4072,4238,8105,205,130,575.17,14.4
"2011","CM11 1","CM11 1","Total",7237,3630,3607,7228,9,144,1348.00,5.4
"2011","CM11 2","CM11 2","Total",11764,5682,6082,11759,5,167,1262.52,9.3
"2011","CM12 0","CM12 0","Total",12334,6013,6321,12264,70,204,542.74,22.7
"2011","CM12 9","CM12 9","Total",7488,3659,3829,7484,4,119,1448.23,5.2
"2011","CM13 1","CM13 1","Total",8383,4055,4328,8302,81,146,1379.61,6.1
"2011","CM13 2","CM13 2","Total",10236,4904,5332,10232,4,218,434.67,23.5
"2011","CM13 3","CM13 3","Total",5875,2855,3020,5637,238,101,3692.82,1.6
"2011","CM14 4","CM14 4","Total",10536,5097,5439,10380,156,160,279.61,37.7
"2011","CM14 5","CM14 5","Total",9210,4478,4732,9086,124,134,3229.23,2.9
"2011","CM15 0","CM15 0","Total",8835,4311,4524,8829,6,164,2643.63,3.3
"2011","CM15 8","CM15 8","Total",5759,2838,2921,5759,0,173,596.44,9.7
"2011","CM15 9","CM15 9","Total",8812,4225,4587,8625,187,115,709.71,12.4
"2011","CM16 4","CM16 4","Total",3688,1757,1931,3624,64,39,139.75,26.4
"2011","CM16 5","CM16 5","Total",3512,1679,1833,3511,1,49,195.62,18.0
"2011","CM16 6","CM16 6","Total",8034,3882,4152,7923,111,109,3035.20,2.6
"2011","CM16 7","CM16 7","Total",6862,3321,3541,6778,84,120,2600.74,2.6
"2011","CM17 0","CM17 0","Total",6859,3260,3599,6840,19,85,1969.60,3.5
"2011","CM17 9","CM17 9","Total",14437,6993,7444,14407,30,100,1625.15,8.9
"2011","CM18 6","CM18 6","Total",12859,6144,6715,12702,157,113,307.31,41.8
"2011","CM18 7","CM18 7","Total",11566,5602,5964,11560,6,109,257.55,44.9
"2011","CM19 4","CM19 4","Total",10841,5324,5517,10836,5,107,272.06,39.8
"2011","CM19 5","CM19 5","Total",7970,3928,4042,7938,32,75,988.94,8.1
"2011","CM2  0","CM2  0","Total",5299,2679,2620,5183,116,41,107.13,49.5
"2011","CM2  6","CM2  6","Total",14995,7518,7477,14717,278,254,587.94,25.5
"2011","CM2  7","CM2  7","Total",8423,4101,4322,8354,69,122,1442.09,5.8
"2011","CM2  8","CM2  8","Total",14882,7264,7618,14882,0,229,2474.73,6.0
"2011","CM2  9","CM2  9","Total",14653,7215,7438,14590,63,208,378.00,38.8
"2011","CM20 1","CM20 1","Total",6371,3112,3259,6299,72,43,496.06,12.8
"2011","CM20 2","CM20 2","Total",4013,1978,2035,4011,2,26,1169.43,3.4
"2011","CM20 3","CM20 3","Total",11016,5288,5728,10940,76,90,257.01,42.9
"2011","CM21 0","CM21 0","Total",4308,2128,2180,4176,132,87,2289.68,1.9
"2011","CM21 9","CM21 9","Total",6530,3221,3309,6530,0,89,424.83,15.4
"2011","CM22 6","CM22 6","Total",6840,3383,3457,6813,27,122,4446.30,1.5
"2011","CM22 7","CM22 7","Total",6392,3151,3241,6358,34,134,5584.14,1.1
"2011","CM23 1","CM23 1","Total",1552,769,783,1552,0,43,2604.19,0.6
"2011","CM23 2","CM23 2","Total",7264,3541,3723,7100,164,202,556.60,13.1
"2011","CM23 3","CM23 3","Total",9337,4599,4738,9310,27,104,203.62,45.9
"2011","CM23 4","CM23 4","Total",13349,6527,6822,13291,58,316,963.49,13.9
"2011","CM23 5","CM23 5","Total",9113,4439,4674,8817,296,188,675.41,13.5
"2011","CM24 8","CM24 8","Total",6669,3346,3323,6594,75,108,1647.00,4.0
"2011","CM3  1","CM3  1","Total",5614,2795,2819,5614,0,94,5496.62,1.0
"2011","CM3  2","CM3  2","Total",5430,2664,2766,5325,105,97,4426.90,1.2
"2011","CM3  3","CM3  3","Total",4913,2406,2507,4742,171,82,2745.86,1.8
"2011","CM3  4","CM3  4","Total",9242,4594,4648,9207,35,200,3074.12,3.0
"2011","CM3  5","CM3  5","Total",14894,7373,7521,14894,0,225,799.38,18.6
"2011","CM3  6","CM3  6","Total",9396,4722,4674,9357,39,121,6336.69,1.5
"2011","CM3  7","CM3  7","Total",1559,750,809,1487,72,32,53.12,29.3
"2011","CM3  8","CM3  8","Total",3060,1493,1567,3029,31,40,3062.12,1.0
"2011","CM4  0","CM4  0","Total",4575,2219,2356,4559,16,84,4089.70,1.1
"2011","CM4  9","CM4  9","Total",5606,2665,2941,5606,0,119,2216.53,2.5
"2011","CM5  0","CM5  0","Total",5402,2640,2762,5402,0,83,7602.43,0.7
"2011","CM5  9","CM5  9","Total",5179,2538,2641,5162,17,88,2921.70,1.8
"2011","CM6  1","CM6  1","Total",11691,5709,5982,11560,131,174,7033.02,1.7
"2011","CM6  2","CM6  2","Total",6243,3049,3194,6177,66,122,5783.01,1.1
"2011","CM6  3","CM6  3","Total",7250,3591,3659,6931,319,177,6415.92,1.1
"2011","CM7  1","CM7  1","Total",9301,4562,4739,9198,103,90,285.07,32.6
"2011","CM7  2","CM7  2","Total",5528,2675,2853,5522,6,64,127.25,43.4
"2011","CM7  3","CM7  3","Total",11019,5434,5585,10984,35,78,246.57,44.7
"2011","CM7  4","CM7  4","Total",4231,2099,2132,4194,37,110,7340.13,0.6
"2011","CM7  5","CM7  5","Total",9412,4575,4837,9165,247,93,3993.07,2.4
"2011","CM7  9","CM7  9","Total",9252,4574,4678,9045,207,105,543.81,17.0
"2011","CM77 6","CM77 6","Total",2646,1287,1359,2641,5,31,868.17,3.0
"2011","CM77 7","CM77 7","Total",7451,3571,3880,7445,6,91,400.61,18.6
"2011","CM77 8","CM77 8","Total",5298,2659,2639,5205,93,75,4017.98,1.3
"2011","CM8  1","CM8  1","Total",13990,6849,7141,13886,104,144,1592.48,8.8
"2011","CM8  2","CM8  2","Total",11885,5772,6113,11809,76,89,562.77,21.1
"2011","CM8  3","CM8  3","Total",6932,3431,3501,6848,84,73,3533.89,2.0
"2011","CM9  4","CM9  4","Total",8896,4410,4486,8778,118,80,1147.14,7.8
"2011","CM9  5","CM9  5","Total",4265,2053,2212,4236,29,28,94.08,45.3
"2011","CM9  6","CM9  6","Total",11368,5506,5862,11273,95,173,5702.41,2.0
"2011","CM9  8","CM9  8","Total",8996,4470,4526,8862,134,151,8077.01,1.1
"2011","CO1  1","CO1  1","Total",4670,2316,2354,4621,49,32,200.69,23.3
"2011","CO1  2","CO1  2","Total",10318,5068,5250,10199,119,89,217.82,47.4
"2011","CO10 0","CO10 0","Total",13376,6604,6772,13217,159,184,5394.78,2.5
"2011","CO10 1","CO10 1","Total",8320,4000,4320,8215,105,92,266.33,31.2
"2011","CO10 2","CO10 2","Total",4410,2093,2317,4286,124,35,450.45,9.8
"2011","CO10 5","CO10 5","Total",2263,1138,1125,2256,7,63,3036.57,0.7
"2011","CO10 7","CO10 7","Total",6438,3221,3217,6419,19,109,8213.41,0.8
"2011","CO10 8","CO10 8","Total",5356,2576,2780,5314,42,73,6681.18,0.8
"2011","CO10 9","CO10 9","Total",6166,2994,3172,6074,92,94,5838.29,1.1
"2011","CO11 1","CO11 1","Total",5643,2708,2935,5643,0,66,985.86,5.7
"2011","CO11 2","CO11 2","Total",7307,3575,3732,7226,81,107,5083.18,1.4
"2011","CO12 3","CO12 3","Total",6974,3475,3499,6873,101,42,305.74,22.8
"2011","CO12 4","CO12 4","Total",11264,5403,5861,11226,38,81,516.66,21.8
"2011","CO12 5","CO12 5","Total",3977,1956,2021,3947,30,49,3249.24,1.2
"2011","CO13 0","CO13 0","Total",8108,3814,4294,8027,81,99,1594.21,5.1
"2011","CO13 9","CO13 9","Total",4002,1814,2188,3921,81,72,200.37,20.0
"2011","CO14 8","CO14 8","Total",6735,3018,3717,6538,197,58,698.89,9.6
"2011","CO15 1","CO15 1","Total",7233,3414,3819,6660,573,51,250.47,28.9
"2011","CO15 2","CO15 2","Total",6493,3127,3366,6447,46,21,374.11,17.4
"2011","CO15 3","CO15 3","Total",8623,4134,4489,8600,23,56,145.74,59.2
"2011","CO15 4","CO15 4","Total",8117,3796,4321,8111,6,43,561.01,14.5
"2011","CO15 5","CO15 5","Total",6741,3174,3567,6672,69,44,296.76,22.7
"2011","CO15 6","CO15 6","Total",5847,2710,3137,5517,330,58,191.36,30.6
"2011","CO16 0","CO16 0","Total",3036,1514,1522,2948,88,37,4369.05,0.7
"2011","CO16 7","CO16 7","Total",4919,2360,2559,4919,0,30,178.38,27.6
"2011","CO16 8","CO16 8","Total",10919,5197,5722,10866,53,76,2194.31,5.0
"2011","CO16 9","CO16 9","Total",5322,2590,2732,5258,64,41,3330.94,1.6
"2011","CO2  0","CO2  0","Total",4480,2211,2269,4459,21,69,3166.19,1.4
"2011","CO2  7","CO2  7","Total",9256,5139,4117,7916,1340,74,277.96,33.3
"2011","CO2  8","CO2  8","Total",12673,6215,6458,12076,597,100,665.96,19.0
"2011","CO2  9","CO2  9","Total",8705,4378,4327,8465,240,72,663.63,13.1
"2011","CO3  0","CO3  0","Total",7681,3678,4003,7555,126,93,750.73,10.2
"2011","CO3  3","CO3  3","Total",8002,3951,4051,7776,226,202,486.30,16.5
"2011","CO3  4","CO3  4","Total",6662,3169,3493,6612,50,120,179.94,37.0
"2011","CO3  8","CO3  8","Total",828,411,417,828,0,15,391.66,2.1
"2011","CO3  9","CO3  9","Total",4944,2427,2517,4944,0,93,524.21,9.4
"2011","CO4  0","CO4  0","Total",7230,3532,3698,7173,57,78,225.52,32.1
"2011","CO4  3","CO4  3","Total",17987,8721,9266,15448,2539,188,649.57,27.7
"2011","CO4  5","CO4  5","Total",14008,6945,7063,13841,167,193,3267.75,4.3
"2011","CO4  9","CO4  9","Total",8777,4329,4448,8743,34,120,305.86,28.7
"2011","CO5  0","CO5  0","Total",9875,4779,5096,9833,42,90,1038.97,9.5
"2011","CO5  7","CO5  7","Total",4506,2196,2310,4439,67,59,4601.28,1.0
"2011","CO5  8","CO5  8","Total",7449,3540,3909,7435,14,95,1862.68,4.0
"2011","CO5  9","CO5  9","Total",6369,3191,3178,6271,98,107,4682.81,1.4
"2011","CO6  1","CO6  1","Total",9693,4740,4953,9606,87,147,4469.80,2.2
"2011","CO6  2","CO6  2","Total",6285,3063,3222,6126,159,120,4092.43,1.5
"2011","CO6  3","CO6  3","Total",6185,3033,3152,6113,72,115,3699.59,1.7
"2011","CO6  4","CO6  4","Total",5879,2835,3044,5763,116,153,5095.36,1.2
"2011","CO6  5","CO6  5","Total",851,437,414,844,7,31,1378.65,0.6
"2011","CO7  0","CO7  0","Total",8076,3937,4139,7989,87,75,1143.20,7.1
"2011","CO7  6","CO7  6","Total",5962,2943,3019,5846,116,161,4837.79,1.2
"2011","CO7  7","CO7  7","Total",5487,2766,2721,5387,100,103,5191.44,1.1
"2011","CO7  8","CO7  8","Total",5791,2854,2937,5658,133,87,3669.53,1.6
"2011","CO7  9","CO7  9","Total",7637,3738,3899,7629,8,92,484.27,15.8
"2011","CO8  5","CO8  5","Total",2303,1138,1165,2303,0,75,3384.94,0.7
"2011","CO9  1","CO9  1","Total",9398,4612,4786,9235,163,83,3248.87,2.9
"2011","CO9  2","CO9  2","Total",6044,2942,3102,5966,78,83,2972.25,2.0
"2011","CO9  3","CO9  3","Total",5616,2779,2837,5583,33,92,4144.31,1.4
"2011","CO9  4","CO9  4","Total",4202,2112,2090,4199,3,57,5654.61,0.7
"2011","CR0  0","CR0  0","Total",18285,8465,9820,18225,60,128,334.61,54.6
"2011","CR0  1","CR0  1","Total",8974,4620,4354,8819,155,57,136.70,65.6
"2011","CR0  2","CR0  2","Total",19388,9720,9668,19113,275,148,200.72,96.6
"2011","CR0  3","CR0  3","Total",18754,9178,9576,18739,15,172,283.98,66.0
"2011","CR0  4","CR0  4","Total",16782,8088,8694,16738,44,188,571.98,29.3
"2011","CR0  5","CR0  5","Total",10713,5278,5435,10406,307,187,684.00,15.7
"2011","CR0  6","CR0  6","Total",21899,10870,11029,21785,114,205,220.04,99.5
"2011","CR0  7","CR0  7","Total",16011,7720,8291,15989,22,222,296.60,54.0
"2011","CR0  8","CR0  8","Total",12934,6105,6829,12934,0,262,267.41,48.4
"2011","CR0  9","CR0  9","Total",10493,4899,5594,10493,0,114,369.57,28.4
"2011","CR2  0","CR2  0","Total",10999,5425,5574,10876,123,240,352.13,31.2
"2011","CR2  6","CR2  6","Total",10864,5300,5564,10600,264,85,210.78,51.5
"2011","CR2  7","CR2  7","Total",8235,4109,4126,8046,189,126,268.08,30.7
"2011","CR2  8","CR2  8","Total",11285,5385,5900,11247,38,193,554.69,20.3
"2011","CR2  9","CR2  9","Total",7084,3414,3670,7084,0,109,395.88,17.9
"2011","CR3  0","CR3  0","Total",4283,2137,2146,4281,2,30,236.97,18.1
"2011","CR3  5","CR3  5","Total",12701,6149,6552,12412,289,207,683.93,18.6
"2011","CR3  6","CR3  6","Total",9414,4603,4811,9104,310,181,705.38,13.3
"2011","CR3  7","CR3  7","Total",2141,901,1240,1864,277,74,1087.30,2.0
"2011","CR4  1","CR4  1","Total",17002,8250,8752,16986,16,204,321.09,53.0
"2011","CR4  2","CR4  2","Total",13403,6770,6633,13379,24,132,132.06,101.5
"2011","CR4  3","CR4  3","Total",18775,9080,9695,18775,0,179,194.67,96.4
"2011","CR4  4","CR4  4","Total",9622,4737,4885,9336,286,108,339.00,28.4
"2011","CR5  1","CR5  1","Total",10639,5135,5504,10606,33,160,940.58,11.3
"2011","CR5  2","CR5  2","Total",9162,4475,4687,9112,50,162,367.04,25.0
"2011","CR5  3","CR5  3","Total",9061,4435,4626,8999,62,181,1273.07,7.1
"2011","CR6  9","CR6  9","Total",9843,4740,5103,9777,66,182,2139.72,4.6
"2011","CR7  6","CR7  6","Total",9048,4339,4709,9028,20,134,95.38,94.9
"2011","CR7  7","CR7  7","Total",17686,8632,9054,17504,182,227,165.31,107.0
"2011","CR7  8","CR7  8","Total",17957,8488,9469,17886,71,240,194.91,92.1
"2011","CR8  1","CR8  1","Total",4855,2380,2475,4833,22,120,164.28,29.6
"2011","CR8  2","CR8  2","Total",8289,4035,4254,8032,257,128,201.76,41.1
"2011","CR8  3","CR8  3","Total",5004,2459,2545,4830,174,185,267.37,18.7
"2011","CR8  4","CR8  4","Total",6090,2969,3121,5992,98,120,170.43,35.7
"2011","CR8  5","CR8  5","Total",8307,3994,4313,8081,226,148,452.70,18.3
"2011","CT1  1","CT1  1","Total",14531,7164,7367,12841,1690,195,853.16,17.0
"2011","CT1  2","CT1  2","Total",4296,2064,2232,3760,536,49,99.88,43.0
"2011","CT1  3","CT1  3","Total",11928,5743,6185,11424,504,219,781.43,15.3
"2011","CT10 1","CT10 1","Total",7056,3423,3633,6790,266,116,207.66,34.0
"2011","CT10 2","CT10 2","Total",10522,4893,5629,10256,266,145,520.22,20.2
"2011","CT10 3","CT10 3","Total",7325,3471,3854,7143,182,85,407.93,18.0
"2011","CT11 0","CT11 0","Total",7465,3598,3867,7409,56,75,265.36,28.1
"2011","CT11 7","CT11 7","Total",9169,4434,4735,8923,246,72,155.37,59.0
"2011","CT11 8","CT11 8","Total",5761,2790,2971,5710,51,53,86.53,66.6
"2011","CT11 9","CT11 9","Total",6811,3404,3407,6717,94,65,108.18,63.0
"2011","CT12 4","CT12 4","Total",3882,1885,1997,3866,16,48,2722.62,1.4
"2011","CT12 5","CT12 5","Total",2742,1333,1409,2736,6,33,747.85,3.7
"2011","CT12 6","CT12 6","Total",11202,5348,5854,11182,20,54,371.91,30.1
"2011","CT13 0","CT13 0","Total",5957,2837,3120,5891,66,82,2314.11,2.6
"2011","CT13 9","CT13 9","Total",2944,1444,1500,2889,55,61,1971.60,1.5
"2011","CT14 0","CT14 0","Total",2960,1445,1515,2790,170,43,3205.01,0.9
"2011","CT14 6","CT14 6","Total",5355,2642,2713,5347,8,44,105.32,50.8
"2011","CT14 7","CT14 7","Total",9173,4415,4758,8912,261,96,237.81,38.6
"2011","CT14 8","CT14 8","Total",2694,1314,1380,2613,81,36,1277.41,2.1
"2011","CT14 9","CT14 9","Total",14874,7054,7820,14682,192,141,529.08,28.1
"2011","CT15 4","CT15 4","Total",3706,1812,1894,3693,13,43,2091.79,1.8
"2011","CT15 5","CT15 5","Total",3289,1722,1567,2858,431,61,3662.27,0.9
"2011","CT15 6","CT15 6","Total",2499,1208,1291,2491,8,39,1303.18,1.9
"2011","CT15 7","CT15 7","Total",3744,1833,1911,3673,71,48,3983.95,0.9
"2011","CT16 1","CT16 1","Total",3447,1772,1675,3349,98,28,188.04,18.3
"2011","CT16 2","CT16 2","Total",10592,5222,5370,10557,35,64,385.40,27.5
"2011","CT16 3","CT16 3","Total",5584,2708,2876,5409,175,73,982.59,5.7
"2011","CT17 0","CT17 0","Total",12301,6114,6187,12153,148,99,549.00,22.4
"2011","CT17 9","CT17 9","Total",9785,4972,4813,9490,295,90,709.27,13.8
"2011","CT18 7","CT18 7","Total",10823,5315,5508,10782,41,112,1864.22,5.8
"2011","CT18 8","CT18 8","Total",3086,1476,1610,3065,21,53,2427.69,1.3
"2011","CT19 4","CT19 4","Total",9199,4426,4773,9199,0,58,395.24,23.3
"2011","CT19 5","CT19 5","Total",10233,5055,5178,10092,141,100,249.46,41.0
"2011","CT19 6","CT19 6","Total",9435,4520,4915,9434,1,65,411.74,22.9
"2011","CT2  0","CT2  0","Total",5883,2818,3065,5746,137,74,1020.23,5.8
"2011","CT2  7","CT2  7","Total",13510,6570,6940,9599,3911,208,482.56,28.0
"2011","CT2  8","CT2  8","Total",7567,3552,4015,7430,137,101,183.10,41.3
"2011","CT2  9","CT2  9","Total",3758,1809,1949,3550,208,113,1578.47,2.4
"2011","CT20 1","CT20 1","Total",7046,3913,3133,6948,98,35,77.61,90.8
"2011","CT20 2","CT20 2","Total",7545,3741,3804,7141,404,60,182.79,41.3
"2011","CT20 3","CT20 3","Total",7879,4037,3842,7573,306,87,299.83,26.3
"2011","CT21 4","CT21 4","Total",4377,2087,2290,4310,67,93,3086.35,1.4
"2011","CT21 5","CT21 5","Total",6446,3008,3438,6160,286,73,505.15,12.8
"2011","CT21 6","CT21 6","Total",6324,2965,3359,6311,13,47,263.33,24.0
"2011","CT3  1","CT3  1","Total",5858,2805,3053,5772,86,146,5584.02,1.0
"2011","CT3  2","CT3  2","Total",3365,1662,1703,3291,74,34,2837.00,1.2
"2011","CT3  3","CT3  3","Total",4438,2144,2294,4429,9,32,1377.72,3.2
"2011","CT3  4","CT3  4","Total",3623,1798,1825,3540,83,37,4486.44,0.8
"2011","CT4  5","CT4  5","Total",4171,1970,2201,4068,103,119,5166.82,0.8
"2011","CT4  6","CT4  6","Total",5127,2512,2615,5030,97,121,9018.42,0.6
"2011","CT4  7","CT4  7","Total",5455,2671,2784,5445,10,82,4926.58,1.1
"2011","CT4  8","CT4  8","Total",1880,915,965,1868,12,35,2424.44,0.8
"2011","CT5  1","CT5  1","Total",7536,3592,3944,7491,45,75,214.05,35.2
"2011","CT5  2","CT5  2","Total",8245,3849,4396,8157,88,112,254.91,32.3
"2011","CT5  3","CT5  3","Total",6778,3267,3511,6744,34,98,2450.22,2.8
"2011","CT5  4","CT5  4","Total",10509,4991,5518,10398,111,87,938.58,11.2
"2011","CT6  5","CT6  5","Total",7481,3587,3894,7308,173,70,195.66,38.2
"2011","CT6  6","CT6  6","Total",9818,4616,5202,9446,372,95,935.21,10.5
"2011","CT6  7","CT6  7","Total",12628,6193,6435,12517,111,120,1735.10,7.3
"2011","CT6  8","CT6  8","Total",8636,4111,4525,8467,169,55,240.03,36.0
"2011","CT7  0","CT7  0","Total",4045,1959,2086,4039,6,33,2214.67,1.8
"2011","CT7  9","CT7  9","Total",7414,3399,4015,7323,91,82,525.43,14.1
"2011","CT8  8","CT8  8","Total",7338,3432,3906,7010,328,54,221.76,33.1
"2011","CT9  1","CT9  1","Total",6759,3443,3316,6589,170,42,99.97,67.6
"2011","CT9  2","CT9  2","Total",10779,5312,5467,10353,426,83,136.73,78.8
"2011","CT9  3","CT9  3","Total",11077,5224,5853,11035,42,87,333.16,33.2
"2011","CT9  4","CT9  4","Total",3862,1824,2038,3766,96,19,817.89,4.7
"2011","CT9  5","CT9  5","Total",10977,5383,5594,10908,69,110,390.29,28.1
"2011","CV1  1","CV1  1","Total",437,259,178,257,180,7,23.46,18.6
"2011","CV1  2","CV1  2","Total",6764,3758,3006,6225,539,76,142.78,47.4
"2011","CV1  3","CV1  3","Total",5001,2823,2178,4241,760,62,66.78,74.9
"2011","CV1  4","CV1  4","Total",8165,4369,3796,7939,226,79,148.62,54.9
"2011","CV1  5","CV1  5","Total",10814,5769,5045,8523,2291,128,134.38,80.5
"2011","CV10 0","CV10 0","Total",12587,6102,6485,12519,68,112,2668.29,4.7
"2011","CV10 7","CV10 7","Total",11078,5423,5655,10997,81,87,1455.15,7.6
"2011","CV10 8","CV10 8","Total",11974,5914,6060,11969,5,71,305.05,39.3
"2011","CV10 9","CV10 9","Total",14244,7027,7217,14198,46,114,1040.38,13.7
"2011","CV11 4","CV11 4","Total",12061,5845,6216,11920,141,121,410.82,29.4
"2011","CV11 5","CV11 5","Total",11114,5570,5544,11034,80,92,208.91,53.2
"2011","CV11 6","CV11 6","Total",16253,8151,8102,15871,382,355,2340.48,6.9
"2011","CV12 0","CV12 0","Total",9099,4431,4668,9050,49,91,645.17,14.1
"2011","CV12 8","CV12 8","Total",10682,5243,5439,10571,111,73,276.22,38.7
"2011","CV12 9","CV12 9","Total",11825,5768,6057,11807,18,91,1551.36,7.6
"2011","CV13 0","CV13 0","Total",6402,3165,3237,6341,61,133,5605.88,1.1
"2011","CV13 6","CV13 6","Total",4312,2177,2135,4164,148,80,5590.53,0.8
"2011","CV2  1","CV2  1","Total",12001,5737,6264,11926,75,63,346.90,34.6
"2011","CV2  2","CV2  2","Total",12524,6018,6506,12438,86,144,542.51,23.1
"2011","CV2  3","CV2  3","Total",13010,6395,6615,12980,30,87,237.43,54.8
"2011","CV2  4","CV2  4","Total",13683,7097,6586,13590,93,131,189.39,72.2
"2011","CV2  5","CV2  5","Total",11988,5824,6164,11942,46,130,229.17,52.3
"2011","CV21 1","CV21 1","Total",9843,4856,4987,9829,14,110,539.11,18.3
"2011","CV21 2","CV21 2","Total",7990,4104,3886,7913,77,59,178.51,44.8
"2011","CV21 3","CV21 3","Total",10227,5230,4997,10115,112,154,289.63,35.3
"2011","CV21 4","CV21 4","Total",7530,3783,3747,7470,60,74,431.85,17.4
"2011","CV22 5","CV22 5","Total",9369,4682,4687,8724,645,167,744.11,12.6
"2011","CV22 6","CV22 6","Total",10470,5041,5429,10237,233,167,442.58,23.7
"2011","CV22 7","CV22 7","Total",15494,7561,7933,15324,170,223,1681.08,9.2
"2011","CV23 0","CV23 0","Total",9612,4799,4813,9413,199,140,10135.28,0.9
"2011","CV23 8","CV23 8","Total",5613,3281,2332,4496,1117,101,9105.78,0.6
"2011","CV23 9","CV23 9","Total",6611,3284,3327,6557,54,123,5753.19,1.1
"2011","CV3  1","CV3  1","Total",8880,4435,4445,8775,105,73,244.35,36.3
"2011","CV3  2","CV3  2","Total",16357,8049,8308,16217,140,190,702.43,23.3
"2011","CV3  3","CV3  3","Total",7874,3916,3958,7836,38,36,173.53,45.4
"2011","CV3  4","CV3  4","Total",4249,2097,2152,4135,114,25,349.35,12.2
"2011","CV3  5","CV3  5","Total",13479,6591,6888,13419,60,194,301.77,44.7
"2011","CV3  6","CV3  6","Total",12484,6140,6344,12468,16,264,339.42,36.8
"2011","CV31 1","CV31 1","Total",12171,6178,5993,12030,141,130,1065.37,11.4
"2011","CV31 2","CV31 2","Total",12287,6231,6056,12235,52,152,507.53,24.2
"2011","CV31 3","CV31 3","Total",7072,3790,3282,6895,177,61,168.72,41.9
"2011","CV32 4","CV32 4","Total",3149,1593,1556,3128,21,39,320.53,9.8
"2011","CV32 5","CV32 5","Total",8230,4205,4025,7912,318,117,155.56,52.9
"2011","CV32 6","CV32 6","Total",7490,3667,3823,7294,196,153,673.53,11.1
"2011","CV32 7","CV32 7","Total",13827,6728,7099,13712,115,177,1045.98,13.2
"2011","CV33 9","CV33 9","Total",6103,3000,3103,6087,16,105,7039.72,0.9
"2011","CV34 4","CV34 4","Total",4831,2386,2445,4724,107,48,216.83,22.3
"2011","CV34 5","CV34 5","Total",14218,7120,7098,14110,108,161,551.36,25.8
"2011","CV34 6","CV34 6","Total",12296,6047,6249,12284,12,226,1422.06,8.6
"2011","CV35 0","CV35 0","Total",5786,2822,2964,5678,108,146,8660.19,0.7
"2011","CV35 7","CV35 7","Total",5310,2631,2679,5297,13,140,5306.83,1.0
"2011","CV35 8","CV35 8","Total",5676,2747,2929,5676,0,153,4269.16,1.3
"2011","CV35 9","CV35 9","Total",7837,3746,4091,7633,204,157,5935.15,1.3
"2011","CV36 4","CV36 4","Total",6496,3095,3401,6450,46,113,2999.17,2.2
"2011","CV36 5","CV36 5","Total",2790,1362,1428,2785,5,75,7796.51,0.4
"2011","CV37 0","CV37 0","Total",6733,3313,3420,6628,105,104,5122.64,1.3
"2011","CV37 6","CV37 6","Total",6679,3111,3568,6506,173,86,263.93,25.3
"2011","CV37 7","CV37 7","Total",8658,4202,4456,8551,107,209,3151.95,2.7
"2011","CV37 8","CV37 8","Total",6969,3415,3554,6925,44,182,10952.52,0.6
"2011","CV37 9","CV37 9","Total",11959,5804,6155,11775,184,177,3204.74,3.7
"2011","CV4  7","CV4  7","Total",8878,4507,4371,4238,4640,205,591.61,15.0
"2011","CV4  8","CV4  8","Total",8015,3992,4023,7542,473,114,796.73,10.1
"2011","CV4  9","CV4  9","Total",16477,8007,8470,16318,159,120,490.07,33.6
"2011","CV47 0","CV47 0","Total",2213,1044,1169,2213,0,19,128.64,17.2
"2011","CV47 1","CV47 1","Total",4354,2162,2192,4278,76,81,1133.25,3.8
"2011","CV47 2","CV47 2","Total",5145,2596,2549,5035,110,72,9035.13,0.6
"2011","CV47 7","CV47 7","Total",751,368,383,751,0,22,2067.80,0.4
"2011","CV47 8","CV47 8","Total",2491,1260,1231,2491,0,60,3057.28,0.8
"2011","CV47 9","CV47 9","Total",2013,966,1047,1988,25,39,1315.74,1.5
"2011","CV5  6","CV5  6","Total",11915,6032,5883,11769,146,243,310.24,38.4
"2011","CV5  7","CV5  7","Total",11931,5891,6040,11900,31,146,303.88,39.3
"2011","CV5  8","CV5  8","Total",12346,6185,6161,12299,47,111,244.26,50.5
"2011","CV5  9","CV5  9","Total",9776,4706,5070,9650,126,125,1485.54,6.6
"2011","CV6  1","CV6  1","Total",13817,6600,7217,13781,36,151,233.55,59.2
"2011","CV6  2","CV6  2","Total",12131,5918,6213,12057,74,125,385.94,31.4
"2011","CV6  3","CV6  3","Total",10834,5182,5652,10729,105,75,151.03,71.7
"2011","CV6  4","CV6  4","Total",13098,6404,6694,13083,15,111,277.02,47.3
"2011","CV6  5","CV6  5","Total",13469,6853,6616,13387,82,95,247.67,54.4
"2011","CV6  6","CV6  6","Total",10696,5316,5380,10641,55,98,403.17,26.5
"2011","CV6  7","CV6  7","Total",12477,6095,6382,12454,23,96,262.59,47.5
"2011","CV7  7","CV7  7","Total",10748,5275,5473,10703,45,247,5498.00,2.0
"2011","CV7  8","CV7  8","Total",8542,4244,4298,8396,146,74,4912.25,1.7
"2011","CV7  9","CV7  9","Total",8788,4272,4516,8594,194,97,2923.05,3.0
"2011","CV8  1","CV8  1","Total",11021,5409,5612,10977,44,256,3818.41,2.9
"2011","CV8  2","CV8  2","Total",13239,6482,6757,13157,82,308,1950.51,6.8
"2011","CV8  3","CV8  3","Total",6771,3357,3414,6726,45,121,5220.89,1.3
"2011","CV9  1","CV9  1","Total",5796,2853,2943,5760,36,48,417.62,13.9
"2011","CV9  2","CV9  2","Total",8988,4467,4521,8936,52,80,3808.23,2.4
"2011","CV9  3","CV9  3","Total",6420,3133,3287,6390,30,110,6493.87,1.0
"2011","CW1  2","CW1  2","Total",1508,777,731,1508,0,9,80.88,18.6
"2011","CW1  3","CW1  3","Total",17346,8534,8812,17209,137,117,400.93,43.3
"2011","CW1  4","CW1  4","Total",11655,5766,5889,11529,126,73,1790.05,6.5
"2011","CW1  5","CW1  5","Total",10723,5233,5490,9746,977,191,2092.73,5.1
"2011","CW1  6","CW1  6","Total",1147,560,587,1140,7,5,135.67,8.5
"2011","CW10 0","CW10 0","Total",7597,3743,3854,7555,42,79,1013.08,7.5
"2011","CW10 9","CW10 9","Total",6764,3356,3408,6701,63,85,2502.85,2.7
"2011","CW11 1","CW11 1","Total",7236,3513,3723,7169,67,144,2834.98,2.6
"2011","CW11 2","CW11 2","Total",1889,898,991,1858,31,38,1232.89,1.5
"2011","CW11 3","CW11 3","Total",7181,3571,3610,7134,47,117,2467.63,2.9
"2011","CW11 4","CW11 4","Total",6309,3100,3209,6305,4,118,2013.69,3.1
"2011","CW12 1","CW12 1","Total",3872,1960,1912,3768,104,33,157.58,24.6
"2011","CW12 2","CW12 2","Total",4934,2424,2510,4926,8,68,3447.26,1.4
"2011","CW12 3","CW12 3","Total",10059,4970,5089,9939,120,153,1667.68,6.0
"2011","CW12 4","CW12 4","Total",10360,5046,5314,10251,109,150,2777.83,3.7
"2011","CW2  5","CW2  5","Total",8061,3992,4069,8037,24,84,3494.04,2.3
"2011","CW2  6","CW2  6","Total",10648,5370,5278,10575,73,144,435.98,24.4
"2011","CW2  7","CW2  7","Total",9284,4732,4552,9231,53,65,210.31,44.1
"2011","CW2  8","CW2  8","Total",13127,6416,6711,13107,20,104,856.00,15.3
"2011","CW3  0","CW3  0","Total",2755,1334,1421,2671,84,34,2444.34,1.1
"2011","CW3  9","CW3  9","Total",6324,3087,3237,6284,40,132,4426.71,1.4
"2011","CW4  7","CW4  7","Total",5823,2820,3003,5794,29,149,1468.35,4.0
"2011","CW4  8","CW4  8","Total",3555,1769,1786,3544,11,86,2325.57,1.5
"2011","CW5  5","CW5  5","Total",7751,3744,4007,7675,76,59,211.84,36.6
"2011","CW5  6","CW5  6","Total",7412,3571,3841,7110,302,129,4438.84,1.7
"2011","CW5  7","CW5  7","Total",9654,4733,4921,9562,92,153,4959.76,1.9
"2011","CW5  8","CW5  8","Total",4464,2225,2239,4411,53,110,8769.92,0.5
"2011","CW6  0","CW6  0","Total",7005,3380,3625,6876,129,154,4344.71,1.6
"2011","CW6  9","CW6  9","Total",5155,2542,2613,5153,2,170,8634.86,0.6
"2011","CW7  1","CW7  1","Total",9340,4495,4845,9198,142,90,358.57,26.0
"2011","CW7  2","CW7  2","Total",10816,5289,5527,10816,0,120,1363.13,7.9
"2011","CW7  3","CW7  3","Total",9459,4580,4879,9344,115,70,862.98,11.0
"2011","CW7  4","CW7  4","Total",1839,886,953,1835,4,32,2667.12,0.7
"2011","CW8  1","CW8  1","Total",8686,4243,4443,8664,22,156,494.25,17.6
"2011","CW8  2","CW8  2","Total",9087,4470,4617,8974,113,202,5904.75,1.5
"2011","CW8  3","CW8  3","Total",7139,3472,3667,7105,34,97,865.48,8.2
"2011","CW8  4","CW8  4","Total",10378,5074,5304,10352,26,110,1279.52,8.1
"2011","CW9  5","CW9  5","Total",3371,1653,1718,3246,125,20,172.18,19.6
"2011","CW9  6","CW9  6","Total",5661,2851,2810,5661,0,130,4716.99,1.2
"2011","CW9  7","CW9  7","Total",10771,5405,5366,10639,132,71,2042.88,5.3
"2011","CW9  8","CW9  8","Total",13344,6590,6754,13279,65,240,1353.33,9.9
"2011","DA1  1","DA1  1","Total",9614,4840,4774,9611,3,89,270.05,35.6
"2011","DA1  2","DA1  2","Total",11763,5758,6005,11731,32,130,285.64,41.2
"2011","DA1  3","DA1  3","Total",12006,5933,6073,11979,27,188,378.80,31.7
"2011","DA1  4","DA1  4","Total",8370,4050,4320,8349,21,70,291.09,28.8
"2011","DA1  5","DA1  5","Total",10934,5350,5584,10910,24,59,742.97,14.7
"2011","DA10 0","DA10 0","Total",6746,3348,3398,6738,8,45,385.83,17.5
"2011","DA11 0","DA11 0","Total",8909,4556,4353,8720,189,100,124.20,71.7
"2011","DA11 7","DA11 7","Total",9009,4361,4648,8971,38,94,232.54,38.7
"2011","DA11 8","DA11 8","Total",10962,5328,5634,10803,159,78,326.18,33.6
"2011","DA11 9","DA11 9","Total",9179,4580,4599,9119,60,58,350.98,26.2
"2011","DA12 1","DA12 1","Total",6711,3454,3257,6584,127,77,124.50,53.9
"2011","DA12 2","DA12 2","Total",8904,4509,4395,8903,1,68,521.60,17.1
"2011","DA12 3","DA12 3","Total",2356,1136,1220,2282,74,34,2346.37,1.0
"2011","DA12 4","DA12 4","Total",14437,7045,7392,14437,0,142,444.30,32.5
"2011","DA12 5","DA12 5","Total",14984,7227,7757,14934,50,148,279.09,53.7
"2011","DA13 0","DA13 0","Total",9007,4394,4613,8978,29,151,2899.96,3.1
"2011","DA13 9","DA13 9","Total",5442,2672,2770,5392,50,89,1887.59,2.9
"2011","DA14 4","DA14 4","Total",9774,4629,5145,9759,15,113,246.84,39.6
"2011","DA14 5","DA14 5","Total",4193,1978,2215,4174,19,29,603.69,6.9
"2011","DA14 6","DA14 6","Total",7216,3213,4003,7091,125,66,202.20,35.7
"2011","DA15 7","DA15 7","Total",5408,2619,2789,5115,293,72,101.52,53.3
"2011","DA15 8","DA15 8","Total",14900,7196,7704,14783,117,136,251.13,59.3
"2011","DA15 9","DA15 9","Total",9119,4440,4679,9119,0,118,239.94,38.0
"2011","DA16 1","DA16 1","Total",12574,6086,6488,12574,0,132,172.80,72.8
"2011","DA16 2","DA16 2","Total",14284,6906,7378,14284,0,181,245.72,58.1
"2011","DA16 3","DA16 3","Total",9054,4348,4706,8991,63,80,188.84,47.9
"2011","DA17 5","DA17 5","Total",10470,5054,5416,10457,13,96,169.28,61.9
"2011","DA17 6","DA17 6","Total",6634,3169,3465,6634,0,55,305.52,21.7
"2011","DA18 4","DA18 4","Total",4939,2397,2542,4925,14,68,278.86,17.7
"2011","DA2  6","DA2  6","Total",9647,4791,4856,9332,315,72,439.12,22.0
"2011","DA2  7","DA2  7","Total",11704,5651,6053,11450,254,145,1594.83,7.3
"2011","DA2  8","DA2  8","Total",1643,800,843,1643,0,8,337.52,4.9
"2011","DA3  7","DA3  7","Total",7825,3722,4103,7639,186,152,543.90,14.4
"2011","DA3  8","DA3  8","Total",8923,4362,4561,8895,28,148,1297.87,6.9
"2011","DA4  0","DA4  0","Total",3133,1517,1616,3122,11,66,2418.62,1.3
"2011","DA4  9","DA4  9","Total",5929,2857,3072,5894,35,57,1471.56,4.0
"2011","DA5  1","DA5  1","Total",6994,3429,3565,6974,20,92,263.41,26.6
"2011","DA5  2","DA5  2","Total",5262,2606,2656,5199,63,76,335.86,15.7
"2011","DA5  3","DA5  3","Total",8568,4199,4369,8568,0,105,229.14,37.4
"2011","DA6  7","DA6  7","Total",4244,2051,2193,4227,17,49,119.14,35.6
"2011","DA6  8","DA6  8","Total",5602,2752,2850,5589,13,73,144.97,38.6
"2011","DA7  4","DA7  4","Total",12266,5845,6421,12127,139,161,218.58,56.1
"2011","DA7  5","DA7  5","Total",12231,5952,6279,12203,28,174,235.69,51.9
"2011","DA7  6","DA7  6","Total",11043,5324,5719,11033,10,112,241.79,45.7
"2011","DA8  1","DA8  1","Total",13375,6450,6925,13364,11,144,248.70,53.8
"2011","DA8  2","DA8  2","Total",10921,5221,5700,10913,8,99,437.34,25.0
"2011","DA8  3","DA8  3","Total",10263,4966,5297,10142,121,83,178.32,57.6
"2011","DA9  9","DA9  9","Total",13089,6622,6467,12969,120,78,940.80,13.9
"2011","DE1  1","DE1  1","Total",5044,2769,2275,4551,493,36,115.91,43.5
"2011","DE1  2","DE1  2","Total",2422,1418,1004,2285,137,7,121.54,19.9
"2011","DE1  3","DE1  3","Total",6341,3385,2956,5427,914,80,122.23,51.9
"2011","DE11 0","DE11 0","Total",15296,7592,7704,15279,17,102,616.26,24.8
"2011","DE11 7","DE11 7","Total",9745,4839,4906,9694,51,92,1325.31,7.4
"2011","DE11 8","DE11 8","Total",6022,2992,3030,6008,14,49,847.66,7.1
"2011","DE11 9","DE11 9","Total",12746,6366,6380,12628,118,106,743.19,17.2
"2011","DE12 6","DE12 6","Total",7566,3705,3861,7516,50,67,1435.57,5.3
"2011","DE12 7","DE12 7","Total",9101,4598,4503,9097,4,106,2838.29,3.2
"2011","DE12 8","DE12 8","Total",3795,1899,1896,3652,143,53,5308.46,0.7
"2011","DE13 0","DE13 0","Total",18922,9168,9754,18782,140,182,861.88,22.0
"2011","DE13 7","DE13 7","Total",4128,1999,2129,4076,52,82,2478.43,1.7
"2011","DE13 8","DE13 8","Total",7962,3823,4139,7885,77,169,8511.95,0.9
"2011","DE13 9","DE13 9","Total",9584,4684,4900,9558,26,166,4605.99,2.1
"2011","DE14 1","DE14 1","Total",2468,1300,1168,2427,41,17,480.67,5.1
"2011","DE14 2","DE14 2","Total",12501,6192,6309,12423,78,94,422.78,29.6
"2011","DE14 3","DE14 3","Total",13875,7072,6803,13783,92,113,925.74,15.0
"2011","DE15 0","DE15 0","Total",9676,4710,4966,9397,279,91,1849.24,5.2
"2011","DE15 9","DE15 9","Total",14516,7102,7414,14382,134,154,1873.21,7.7
"2011","DE21 2","DE21 2","Total",10435,5154,5281,10414,21,113,236.60,44.1
"2011","DE21 4","DE21 4","Total",13248,6397,6851,13192,56,72,381.24,34.7
"2011","DE21 5","DE21 5","Total",3623,1763,1860,3613,10,83,1467.43,2.5
"2011","DE21 6","DE21 6","Total",17333,8466,8867,17219,114,92,607.09,28.6
"2011","DE21 7","DE21 7","Total",12377,6064,6313,12267,110,92,797.01,15.5
"2011","DE22 1","DE22 1","Total",6464,3143,3321,6302,162,116,315.17,20.5
"2011","DE22 2","DE22 2","Total",13622,6598,7024,13621,1,257,647.61,21.0
"2011","DE22 3","DE22 3","Total",17663,9156,8507,16770,893,113,321.67,54.9
"2011","DE22 4","DE22 4","Total",7862,3740,4122,7856,6,53,1426.12,5.5
"2011","DE22 5","DE22 5","Total",933,476,457,933,0,33,448.98,2.1
"2011","DE23 1","DE23 1","Total",8516,4096,4420,8374,142,100,174.11,48.9
"2011","DE23 2","DE23 2","Total",3042,1419,1623,3042,0,29,107.71,28.2
"2011","DE23 3","DE23 3","Total",6045,2945,3100,6045,0,133,146.32,41.3
"2011","DE23 4","DE23 4","Total",2686,1278,1408,2686,0,60,169.69,15.8
"2011","DE23 6","DE23 6","Total",18975,9539,9436,18713,262,247,306.01,62.0
"2011","DE23 8","DE23 8","Total",20636,10467,10169,20400,236,110,292.78,70.5
"2011","DE24 0","DE24 0","Total",15565,7622,7943,15450,115,94,478.23,32.5
"2011","DE24 1","DE24 1","Total",1010,527,483,1010,0,4,92.07,11.0
"2011","DE24 3","DE24 3","Total",6249,3133,3116,6249,0,58,274.75,22.7
"2011","DE24 5","DE24 5","Total",1287,661,626,1287,0,13,180.12,7.1
"2011","DE24 8","DE24 8","Total",16740,8218,8522,16582,158,89,593.59,28.2
"2011","DE24 9","DE24 9","Total",13672,6587,7085,13538,134,94,438.09,31.2
"2011","DE3  0","DE3  0","Total",7926,3772,4154,7872,54,142,214.46,37.0
"2011","DE3  9","DE3  9","Total",9082,4437,4645,8990,92,163,341.53,26.6
"2011","DE4  2","DE4  2","Total",9049,4398,4651,8982,67,155,8392.11,1.1
"2011","DE4  3","DE4  3","Total",12089,5951,6138,11883,206,200,2217.84,5.5
"2011","DE4  4","DE4  4","Total",6817,3431,3386,6798,19,103,5836.66,1.2
"2011","DE4  5","DE4  5","Total",5211,2579,2632,5178,33,102,2662.59,2.0
"2011","DE45 1","DE45 1","Total",8676,4087,4589,8398,278,195,13050.21,0.7
"2011","DE5  3","DE5  3","Total",13279,6480,6799,13118,161,114,1204.04,11.0
"2011","DE5  8","DE5  8","Total",3907,1942,1965,3907,0,40,1309.97,3.0
"2011","DE5  9","DE5  9","Total",4847,2408,2439,4773,74,31,531.67,9.1
"2011","DE55 1","DE55 1","Total",6751,3336,3415,6719,32,88,557.63,12.1
"2011","DE55 2","DE55 2","Total",7161,3561,3600,7109,52,42,652.33,11.0
"2011","DE55 3","DE55 3","Total",3781,1935,1846,3758,23,30,179.96,21.0
"2011","DE55 4","DE55 4","Total",8558,4230,4328,8529,29,39,916.67,9.3
"2011","DE55 5","DE55 5","Total",8176,4016,4160,8083,93,57,1661.89,4.9
"2011","DE55 6","DE55 6","Total",7312,3563,3749,7253,59,62,3216.78,2.3
"2011","DE55 7","DE55 7","Total",9485,4644,4841,9308,177,67,1816.49,5.2
"2011","DE56 0","DE56 0","Total",12408,6046,6362,12260,148,165,1507.49,8.2
"2011","DE56 1","DE56 1","Total",13418,6568,6850,13244,174,130,446.22,30.1
"2011","DE56 2","DE56 2","Total",9172,4626,4546,9097,75,129,7481.56,1.2
"2011","DE56 4","DE56 4","Total",5376,2598,2778,5316,60,180,1283.64,4.2
"2011","DE6  1","DE6  1","Total",11115,5443,5672,11011,104,218,9804.67,1.1
"2011","DE6  2","DE6  2","Total",5392,2662,2730,5332,60,116,14587.62,0.4
"2011","DE6  3","DE6  3","Total",3518,1679,1839,3486,32,67,6502.40,0.5
"2011","DE6  4","DE6  4","Total",1060,523,537,1033,27,29,2558.92,0.4
"2011","DE6  5","DE6  5","Total",4508,2521,1987,3794,714,61,7243.59,0.6
"2011","DE65 5","DE65 5","Total",11968,5871,6097,11783,185,129,4364.28,2.7
"2011","DE65 6","DE65 6","Total",11488,5740,5748,10751,737,219,7524.29,1.5
"2011","DE7  4","DE7  4","Total",12656,6194,6462,12547,109,73,2283.89,5.5
"2011","DE7  5","DE7  5","Total",9980,4939,5041,9855,125,54,318.11,31.4
"2011","DE7  6","DE7  6","Total",10477,5109,5368,10270,207,139,3271.69,3.2
"2011","DE7  8","DE7  8","Total",13685,6714,6971,13509,176,64,421.43,32.5
"2011","DE7  9","DE7  9","Total",3118,1541,1577,3118,0,24,96.54,32.3
"2011","DE72 2","DE72 2","Total",4120,2020,2100,4088,32,74,2071.95,2.0
"2011","DE72 3","DE72 3","Total",16105,7788,8317,15910,195,211,3811.36,4.2
"2011","DE73 5","DE73 5","Total",4815,2366,2449,4796,19,62,186.24,25.9
"2011","DE73 6","DE73 6","Total",6566,3162,3404,6557,9,95,223.54,29.4
"2011","DE73 7","DE73 7","Total",1799,909,890,1799,0,38,3837.19,0.5
"2011","DE73 8","DE73 8","Total",5872,2900,2972,5857,15,135,3188.94,1.8
"2011","DE74 2","DE74 2","Total",11491,5762,5729,11363,128,160,4414.29,2.6
"2011","DE75 7","DE75 7","Total",18713,9233,9480,18595,118,131,1463.54,12.8
"2011","DH1  1","DH1  1","Total",9337,4642,4695,8899,438,92,576.10,16.2
"2011","DH1  2","DH1  2","Total",8622,4156,4466,8488,134,103,1327.27,6.5
"2011","DH1  3","DH1  3","Total",9701,5060,4641,4045,5656,161,885.11,11.0
"2011","DH1  4","DH1  4","Total",7661,3867,3794,7421,240,191,383.89,20.0
"2011","DH1  5","DH1  5","Total",14544,7319,7225,13131,1413,244,1504.11,9.7
"2011","DH2  1","DH2  1","Total",10749,5234,5515,10681,68,86,994.57,10.8
"2011","DH2  2","DH2  2","Total",10239,4854,5385,10154,85,72,546.01,18.8
"2011","DH2  3","DH2  3","Total",9439,4684,4755,9354,85,115,1100.06,8.6
"2011","DH3  1","DH3  1","Total",7331,3505,3826,7264,67,54,358.40,20.5
"2011","DH3  2","DH3  2","Total",5578,2705,2873,5526,52,21,258.76,21.6
"2011","DH3  3","DH3  3","Total",6677,3248,3429,6614,63,66,337.67,19.8
"2011","DH3  4","DH3  4","Total",6318,2996,3322,6318,0,63,1122.90,5.6
"2011","DH4  4","DH4  4","Total",8240,4039,4201,8180,60,45,795.37,10.4
"2011","DH4  5","DH4  5","Total",6848,3304,3544,6782,66,29,258.86,26.5
"2011","DH4  6","DH4  6","Total",8944,4273,4671,8830,114,67,1969.67,4.5
"2011","DH4  7","DH4  7","Total",9439,4621,4818,9392,47,65,426.92,22.1
"2011","DH5  0","DH5  0","Total",7166,3472,3694,7159,7,28,1042.31,6.9
"2011","DH5  8","DH5  8","Total",5870,2827,3043,5858,12,33,623.97,9.4
"2011","DH5  9","DH5  9","Total",6498,3135,3363,6436,62,39,1018.27,6.4
"2011","DH6  1","DH6  1","Total",6792,3317,3475,6792,0,66,2592.69,2.6
"2011","DH6  2","DH6  2","Total",9222,4611,4611,9163,59,54,2260.67,4.1
"2011","DH6  3","DH6  3","Total",5601,2792,2809,5555,46,27,1054.92,5.3
"2011","DH6  4","DH6  4","Total",7027,3473,3554,7009,18,58,2850.06,2.5
"2011","DH6  5","DH6  5","Total",4750,2336,2414,4683,67,46,1289.58,3.7
"2011","DH7  0","DH7  0","Total",5646,2759,2887,5642,4,77,5138.74,1.1
"2011","DH7  6","DH7  6","Total",8411,4175,4236,8383,28,69,2746.66,3.1
"2011","DH7  7","DH7  7","Total",7936,3861,4075,7869,67,77,2137.34,3.7
"2011","DH7  8","DH7  8","Total",9980,4855,5125,9900,80,114,2633.90,3.8
"2011","DH7  9","DH7  9","Total",9402,4533,4869,9290,112,78,3730.25,2.5
"2011","DH8  0","DH8  0","Total",6805,3350,3455,6708,97,76,579.84,11.7
"2011","DH8  5","DH8  5","Total",6301,3139,3162,6222,79,62,277.00,22.7
"2011","DH8  6","DH8  6","Total",6940,3435,3505,6777,163,60,1548.35,4.5
"2011","DH8  7","DH8  7","Total",9034,4354,4680,8918,116,58,913.61,9.9
"2011","DH8  8","DH8  8","Total",6616,3185,3431,6593,23,37,577.74,11.5
"2011","DH8  9","DH8  9","Total",2855,1416,1439,2839,16,54,21037.34,0.1
"2011","DH9  0","DH9  0","Total",4757,2372,2385,4635,122,46,841.10,5.7
"2011","DH9  6","DH9  6","Total",10256,5007,5249,10115,141,30,967.25,10.6
"2011","DH9  7","DH9  7","Total",7979,3876,4103,7924,55,40,773.79,10.3
"2011","DH9  8","DH9  8","Total",6866,3360,3506,6864,2,37,784.17,8.8
"2011","DH9  9","DH9  9","Total",6834,3344,3490,6799,35,52,1390.48,4.9
"2011","DL1  1","DL1  1","Total",5013,2463,2550,4930,83,32,339.89,14.7
"2011","DL1  2","DL1  2","Total",11974,5778,6196,11716,258,84,348.20,34.4
"2011","DL1  3","DL1  3","Total",8602,4190,4412,8600,2,114,3877.65,2.2
"2011","DL1  4","DL1  4","Total",14290,6971,7319,13984,306,82,319.21,44.8
"2011","DL1  5","DL1  5","Total",6492,3180,3312,6414,78,62,154.31,42.1
"2011","DL10 4","DL10 4","Total",5249,2548,2701,5192,57,85,1052.86,5.0
"2011","DL10 5","DL10 5","Total",3414,1605,1809,3410,4,77,3323.54,1.0
"2011","DL10 6","DL10 6","Total",2858,1403,1455,2720,138,62,5937.66,0.5
"2011","DL10 7","DL10 7","Total",6903,3639,3264,6235,668,142,2501.99,2.8
"2011","DL11 6","DL11 6","Total",2030,1011,1019,2018,12,44,30873.11,0.1
"2011","DL11 7","DL11 7","Total",3278,1652,1626,3262,16,94,23415.93,0.1
"2011","DL12 0","DL12 0","Total",2494,1241,1253,2483,11,33,29750.90,0.1
"2011","DL12 8","DL12 8","Total",6802,3217,3585,6425,377,109,5728.14,1.2
"2011","DL12 9","DL12 9","Total",3111,1771,1340,2637,474,63,18595.23,0.2
"2011","DL13 1","DL13 1","Total",1481,732,749,1478,3,22,10357.00,0.1
"2011","DL13 2","DL13 2","Total",3100,1563,1537,3056,44,47,15199.72,0.2
"2011","DL13 3","DL13 3","Total",3119,1516,1603,3119,0,49,14286.20,0.2
"2011","DL13 4","DL13 4","Total",3154,1576,1578,3122,32,21,4425.71,0.7
"2011","DL13 5","DL13 5","Total",3304,1648,1656,3303,1,22,4466.78,0.7
"2011","DL14 0","DL14 0","Total",6311,3076,3235,6257,54,90,1981.48,3.2
"2011","DL14 6","DL14 6","Total",11580,5412,6168,11340,240,108,414.35,27.9
"2011","DL14 7","DL14 7","Total",4682,2250,2432,4617,65,57,785.32,6.0
"2011","DL14 8","DL14 8","Total",6803,3405,3398,6773,30,31,2092.08,3.3
"2011","DL14 9","DL14 9","Total",7696,3714,3982,7590,106,54,2104.89,3.7
"2011","DL15 0","DL15 0","Total",8730,4332,4398,8607,123,81,2119.67,4.1
"2011","DL15 8","DL15 8","Total",5297,2580,2717,5235,62,34,2252.22,2.4
"2011","DL15 9","DL15 9","Total",8470,4126,4344,8407,63,70,1279.17,6.6
"2011","DL16 6","DL16 6","Total",11219,5503,5716,11219,0,98,974.15,11.5
"2011","DL16 7","DL16 7","Total",8597,4242,4355,8549,48,72,2074.03,4.1
"2011","DL17 0","DL17 0","Total",4954,2419,2535,4918,36,41,1765.61,2.8
"2011","DL17 8","DL17 8","Total",8942,4357,4585,8871,71,47,870.62,10.3
"2011","DL17 9","DL17 9","Total",3776,1847,1929,3742,34,32,1688.09,2.2
"2011","DL2  1","DL2  1","Total",5868,2860,3008,5669,199,68,4773.56,1.2
"2011","DL2  2","DL2  2","Total",7198,3545,3653,7164,34,155,12550.01,0.6
"2011","DL2  3","DL2  3","Total",3914,1892,2022,3914,0,59,8559.49,0.5
"2011","DL3  0","DL3  0","Total",15145,7452,7693,15047,98,132,564.07,26.8
"2011","DL3  6","DL3  6","Total",8624,4318,4306,8500,124,66,102.77,83.9
"2011","DL3  7","DL3  7","Total",4094,2044,2050,3998,96,88,120.15,34.1
"2011","DL3  8","DL3  8","Total",7742,3652,4090,7575,167,198,483.88,16.0
"2011","DL3  9","DL3  9","Total",9107,4351,4756,9092,15,132,218.00,41.8
"2011","DL4  1","DL4  1","Total",4942,2411,2531,4880,62,33,701.78,7.0
"2011","DL4  2","DL4  2","Total",5034,2445,2589,4972,62,33,360.87,13.9
"2011","DL5  4","DL5  4","Total",9515,4617,4898,9337,178,107,858.76,11.1
"2011","DL5  5","DL5  5","Total",6185,2889,3296,6177,8,49,202.90,30.5
"2011","DL5  6","DL5  6","Total",3997,1977,2020,3997,0,65,2551.62,1.6
"2011","DL5  7","DL5  7","Total",9643,4693,4950,9533,110,102,584.88,16.5
"2011","DL6  1","DL6  1","Total",8869,4380,4489,8644,225,97,1719.16,5.2
"2011","DL6  2","DL6  2","Total",3981,1975,2006,3981,0,82,8782.86,0.5
"2011","DL6  3","DL6  3","Total",2665,1322,1343,2662,3,65,9902.36,0.3
"2011","DL7  0","DL7  0","Total",3135,1564,1571,3134,1,79,10305.75,0.3
"2011","DL7  8","DL7  8","Total",7726,3691,4035,7612,114,133,586.10,13.2
"2011","DL7  9","DL7  9","Total",5357,2875,2482,4647,710,81,5408.50,1.0
"2011","DL8  1","DL8  1","Total",4562,2301,2261,4400,162,107,6920.74,0.7
"2011","DL8  2","DL8  2","Total",4514,2225,2289,4484,30,73,8761.77,0.5
"2011","DL8  3","DL8  3","Total",2928,1449,1479,2924,4,49,27686.44,0.1
"2011","DL8  4","DL8  4","Total",3071,1498,1573,3055,16,55,23257.68,0.1
"2011","DL8  5","DL8  5","Total",3575,1743,1832,3534,41,44,6949.72,0.5
"2011","DL9  3","DL9  3","Total",7423,5065,2358,4625,2798,95,1172.65,6.3
"2011","DL9  4","DL9  4","Total",8436,4324,4112,7684,752,100,1542.53,5.5
"2011","DN1  1","DN1  1","Total",307,156,151,307,0,0,12.87,23.9
"2011","DN1  2","DN1  2","Total",6392,3433,2959,6160,232,58,208.19,30.7
"2011","DN1  3","DN1  3","Total",2036,1152,884,2036,0,12,58.21,35.0
"2011","DN10 4","DN10 4","Total",5286,2637,2649,5241,45,92,5722.11,0.9
"2011","DN10 5","DN10 5","Total",1631,820,811,1555,76,44,2537.78,0.6
"2011","DN10 6","DN10 6","Total",5169,2542,2627,5159,10,109,5527.21,0.9
"2011","DN11 0","DN11 0","Total",13537,6543,6994,13354,183,83,1230.34,11.0
"2011","DN11 8","DN11 8","Total",8294,4041,4253,8177,117,55,1549.24,5.4
"2011","DN11 9","DN11 9","Total",6521,3090,3431,6425,96,102,4619.12,1.4
"2011","DN12 1","DN12 1","Total",7856,3819,4037,7812,44,36,780.08,10.1
"2011","DN12 2","DN12 2","Total",5928,2908,3020,5922,6,37,197.27,30.1
"2011","DN12 3","DN12 3","Total",5803,2805,2998,5742,61,27,223.99,25.9
"2011","DN12 4","DN12 4","Total",4532,2174,2358,4448,84,19,463.77,9.8
"2011","DN14 0","DN14 0","Total",7301,3653,3648,7268,33,84,6632.40,1.1
"2011","DN14 5","DN14 5","Total",7850,3904,3946,7725,125,48,478.16,16.4
"2011","DN14 6","DN14 6","Total",12960,6285,6675,12787,173,88,538.33,24.1
"2011","DN14 7","DN14 7","Total",7172,3570,3602,7142,30,69,10997.93,0.7
"2011","DN14 8","DN14 8","Total",4824,2400,2424,4733,91,53,9305.28,0.5
"2011","DN14 9","DN14 9","Total",6135,2955,3180,6082,53,86,5331.12,1.2
"2011","DN15 0","DN15 0","Total",1067,523,544,981,86,13,4221.78,0.3
"2011","DN15 6","DN15 6","Total",5106,2683,2423,5070,36,30,464.10,11.0
"2011","DN15 7","DN15 7","Total",8581,4364,4217,8495,86,81,217.05,39.5
"2011","DN15 8","DN15 8","Total",12187,6048,6139,12061,126,111,2461.06,5.0
"2011","DN15 9","DN15 9","Total",9662,4816,4846,9623,39,107,6880.19,1.4
"2011","DN16 1","DN16 1","Total",9044,4425,4619,8999,45,60,1040.65,8.7
"2011","DN16 2","DN16 2","Total",8659,4200,4459,8559,100,56,200.56,43.2
"2011","DN16 3","DN16 3","Total",13964,6829,7135,13854,110,153,1607.78,8.7
"2011","DN17 1","DN17 1","Total",12004,5913,6091,11920,84,95,430.66,27.9
"2011","DN17 2","DN17 2","Total",11511,5598,5913,11425,86,88,1406.61,8.2
"2011","DN17 3","DN17 3","Total",7315,3626,3689,7275,40,88,5427.36,1.3
"2011","DN17 4","DN17 4","Total",6358,3216,3142,6324,34,89,8126.98,0.8
"2011","DN18 5","DN18 5","Total",8684,4254,4430,8594,90,86,486.29,17.9
"2011","DN18 6","DN18 6","Total",3033,1437,1596,3017,16,33,2717.20,1.1
"2011","DN19 7","DN19 7","Total",6282,3136,3146,6206,76,75,4365.04,1.4
"2011","DN2  4","DN2  4","Total",8183,4014,4169,8092,91,64,420.90,19.4
"2011","DN2  5","DN2  5","Total",8087,4004,4083,7995,92,113,227.34,35.6
"2011","DN2  6","DN2  6","Total",8281,3930,4351,8212,69,57,267.59,30.9
"2011","DN20 0","DN20 0","Total",6875,3338,3537,6754,121,82,8404.23,0.8
"2011","DN20 8","DN20 8","Total",6812,3354,3458,6669,143,84,1396.53,4.9
"2011","DN20 9","DN20 9","Total",5500,2707,2793,5464,36,79,2462.05,2.2
"2011","DN21 1","DN21 1","Total",11713,5724,5989,11548,165,73,757.60,15.5
"2011","DN21 2","DN21 2","Total",6795,3274,3521,6778,17,60,212.76,31.9
"2011","DN21 3","DN21 3","Total",7346,3562,3784,7155,191,96,9314.84,0.8
"2011","DN21 4","DN21 4","Total",5138,2580,2558,5006,132,93,10609.03,0.5
"2011","DN21 5","DN21 5","Total",6229,3066,3163,6098,131,92,14079.54,0.4
"2011","DN22 0","DN22 0","Total",4803,2549,2254,4354,449,88,8725.50,0.6
"2011","DN22 6","DN22 6","Total",7447,3617,3830,7256,191,87,695.57,10.7
"2011","DN22 7","DN22 7","Total",14903,7300,7603,14813,90,189,1187.29,12.6
"2011","DN22 8","DN22 8","Total",5826,3365,2461,4690,1136,92,8915.22,0.7
"2011","DN22 9","DN22 9","Total",3107,1540,1567,3107,0,60,7771.72,0.4
"2011","DN3  1","DN3  1","Total",8327,4096,4231,8321,6,75,1334.99,6.2
"2011","DN3  2","DN3  2","Total",11824,5786,6038,11737,87,98,578.58,20.4
"2011","DN3  3","DN3  3","Total",9918,4789,5129,9831,87,104,2159.49,4.6
"2011","DN31 1","DN31 1","Total",1928,966,962,1928,0,2,193.89,9.9
"2011","DN31 2","DN31 2","Total",7481,3675,3806,7461,20,48,191.89,39.0
"2011","DN31 3","DN31 3","Total",210,122,88,210,0,0,11.93,17.6
"2011","DN32 0","DN32 0","Total",6619,3353,3266,6408,211,91,198.19,33.4
"2011","DN32 7","DN32 7","Total",6663,3494,3169,6641,22,26,200.46,33.2
"2011","DN32 8","DN32 8","Total",8466,4133,4333,8458,8,42,257.25,32.9
"2011","DN32 9","DN32 9","Total",8509,4344,4165,8364,145,39,169.69,50.1
"2011","DN33 1","DN33 1","Total",7111,3381,3730,7069,42,34,139.47,51.0
"2011","DN33 2","DN33 2","Total",5126,2468,2658,4977,149,72,228.75,22.4
"2011","DN33 3","DN33 3","Total",7301,3538,3763,7255,46,72,210.00,34.8
"2011","DN34 4","DN34 4","Total",8407,4040,4367,8214,193,93,205.58,40.9
"2011","DN34 5","DN34 5","Total",10594,5125,5469,10462,132,64,307.65,34.4
"2011","DN35 0","DN35 0","Total",8606,4078,4528,8536,70,93,439.97,19.6
"2011","DN35 7","DN35 7","Total",11839,5866,5973,11818,21,61,169.26,69.9
"2011","DN35 8","DN35 8","Total",8185,4030,4155,7972,213,45,130.88,62.5
"2011","DN35 9","DN35 9","Total",5931,2820,3111,5930,1,38,142.23,41.7
"2011","DN36 4","DN36 4","Total",10848,5314,5534,10718,130,150,1485.24,7.3
"2011","DN36 5","DN36 5","Total",8255,4030,4225,8147,108,139,8068.60,1.0
"2011","DN37 0","DN37 0","Total",7975,3831,4144,7741,234,138,6256.59,1.3
"2011","DN37 7","DN37 7","Total",3542,1764,1778,3516,26,52,2459.24,1.4
"2011","DN37 8","DN37 8","Total",400,197,203,370,30,6,3249.68,0.1
"2011","DN37 9","DN37 9","Total",9828,4826,5002,9793,35,84,491.83,20.0
"2011","DN38 6","DN38 6","Total",3023,1467,1556,3008,15,53,5491.96,0.6
"2011","DN39 6","DN39 6","Total",2846,1389,1457,2846,0,33,6101.62,0.5
"2011","DN4  0","DN4  0","Total",10620,5352,5268,10558,62,84,241.25,44.0
"2011","DN4  5","DN4  5","Total",5407,2682,2725,5398,9,51,412.52,13.1
"2011","DN4  6","DN4  6","Total",11640,5637,6003,11506,134,164,750.05,15.5
"2011","DN4  7","DN4  7","Total",7766,3723,4043,7669,97,154,245.87,31.6
"2011","DN4  8","DN4  8","Total",7638,3766,3872,7631,7,70,573.83,13.3
"2011","DN4  9","DN4  9","Total",10344,5094,5250,10248,96,102,480.46,21.5
"2011","DN40 1","DN40 1","Total",5650,2715,2935,5562,88,35,1367.68,4.1
"2011","DN40 2","DN40 2","Total",3992,1995,1997,3992,0,25,306.26,13.0
"2011","DN40 3","DN40 3","Total",2657,1323,1334,2657,0,23,4276.23,0.6
"2011","DN41 7","DN41 7","Total",2940,1456,1484,2936,4,55,1136.26,2.6
"2011","DN41 8","DN41 8","Total",3326,1611,1715,3286,40,57,4172.84,0.8
"2011","DN5  0","DN5  0","Total",9827,4751,5076,9730,97,64,2534.12,3.9
"2011","DN5  7","DN5  7","Total",8833,4286,4547,8776,57,175,6567.90,1.3
"2011","DN5  8","DN5  8","Total",11474,5817,5657,10835,639,131,680.57,16.9
"2011","DN5  9","DN5  9","Total",10730,5204,5526,10706,24,91,298.14,36.0
"2011","DN6  0","DN6  0","Total",6283,3119,3164,6235,48,29,3072.15,2.0
"2011","DN6  7","DN6  7","Total",10737,5291,5446,10672,65,58,818.95,13.1
"2011","DN6  8","DN6  8","Total",8688,4220,4468,8597,91,43,1715.39,5.1
"2011","DN6  9","DN6  9","Total",5440,2658,2782,5377,63,50,5182.45,1.0
"2011","DN7  4","DN7  4","Total",8354,4005,4349,8245,109,53,712.45,11.7
"2011","DN7  5","DN7  5","Total",7284,3572,3712,7216,68,30,2698.51,2.7
"2011","DN7  6","DN7  6","Total",8972,5461,3511,6924,2048,94,5493.44,1.6
"2011","DN8  4","DN8  4","Total",9796,4720,5076,9722,74,78,4429.47,2.2
"2011","DN8  5","DN8  5","Total",7499,3678,3821,7421,78,62,270.82,27.7
"2011","DN9  1","DN9  1","Total",8575,4188,4387,8550,25,115,7947.31,1.1
"2011","DN9  2","DN9  2","Total",5039,2443,2596,4992,47,93,5058.57,1.0
"2011","DN9  3","DN9  3","Total",6404,3122,3282,6398,6,115,2647.17,2.4
"2011","DT1  1","DT1  1","Total",5930,2822,3108,5598,332,83,243.32,24.4
"2011","DT1  2","DT1  2","Total",10864,5299,5565,10625,239,216,323.30,33.6
"2011","DT1  3","DT1  3","Total",2266,1094,1172,2266,0,37,145.41,15.6
"2011","DT10 1","DT10 1","Total",6104,2989,3115,6058,46,120,3395.50,1.8
"2011","DT10 2","DT10 2","Total",5737,2837,2900,5689,48,113,8271.47,0.7
"2011","DT11 0","DT11 0","Total",7206,3627,3579,6409,797,188,12782.51,0.6
"2011","DT11 7","DT11 7","Total",10325,5157,5168,10176,149,153,847.01,12.2
"2011","DT11 8","DT11 8","Total",7905,4184,3721,6760,1145,202,11969.60,0.7
"2011","DT11 9","DT11 9","Total",4720,2337,2383,4694,26,99,7516.35,0.6
"2011","DT2  0","DT2  0","Total",3582,1755,1827,3555,27,81,11950.84,0.3
"2011","DT2  7","DT2  7","Total",5738,2816,2922,5687,51,138,22640.56,0.3
"2011","DT2  8","DT2  8","Total",7849,3847,4002,7779,70,153,12630.38,0.6
"2011","DT2  9","DT2  9","Total",7657,3758,3899,7536,121,131,15184.46,0.5
"2011","DT3  4","DT3  4","Total",5626,2773,2853,5591,35,77,5785.09,1.0
"2011","DT3  5","DT3  5","Total",8977,4371,4606,8869,108,130,1757.18,5.1
"2011","DT3  6","DT3  6","Total",8535,4123,4412,8390,145,106,1718.46,5.0
"2011","DT4  0","DT4  0","Total",12649,6170,6479,12521,128,101,408.05,31.0
"2011","DT4  7","DT4  7","Total",7697,3800,3897,7290,407,81,164.32,46.8
"2011","DT4  8","DT4  8","Total",4597,2314,2283,4494,103,38,125.43,36.6
"2011","DT4  9","DT4  9","Total",12350,6047,6303,12309,41,170,513.89,24.0
"2011","DT5  1","DT5  1","Total",6580,3754,2826,5601,979,47,686.56,9.6
"2011","DT5  2","DT5  2","Total",6264,3043,3221,6262,2,53,522.16,12.0
"2011","DT6  3","DT6  3","Total",6302,2983,3319,6223,79,82,2572.99,2.4
"2011","DT6  4","DT6  4","Total",5789,2703,3086,5675,114,109,3187.24,1.8
"2011","DT6  5","DT6  5","Total",5928,2823,3105,5906,22,78,4823.86,1.2
"2011","DT6  6","DT6  6","Total",3540,1709,1831,3484,56,55,6008.93,0.6
"2011","DT7  3","DT7  3","Total",5696,2628,3068,5500,196,117,2904.12,2.0
"2011","DT8  3","DT8  3","Total",6000,2891,3109,5942,58,105,8927.24,0.7
"2011","DT9  3","DT9  3","Total",3568,1702,1866,2658,910,59,141.98,25.1
"2011","DT9  4","DT9  4","Total",5651,2678,2973,5458,193,125,4675.36,1.2
"2011","DT9  5","DT9  5","Total",4950,2447,2503,4948,2,127,8236.96,0.6
"2011","DT9  6","DT9  6","Total",6621,3138,3483,6502,119,146,6367.40,1.0
"2011","DY1  1","DY1  1","Total",748,398,350,715,33,0,22.82,32.8
"2011","DY1  2","DY1  2","Total",14344,7200,7144,14090,254,120,347.45,41.3
"2011","DY1  3","DY1  3","Total",11246,5414,5832,11139,107,69,241.67,46.5
"2011","DY1  4","DY1  4","Total",5793,2849,2944,5737,56,31,288.79,20.1
"2011","DY10 1","DY10 1","Total",7077,3560,3517,6997,80,75,327.49,21.6
"2011","DY10 2","DY10 2","Total",11110,5498,5612,11010,100,92,335.43,33.1
"2011","DY10 3","DY10 3","Total",10247,4899,5348,10124,123,106,2031.19,5.0
"2011","DY10 4","DY10 4","Total",7380,3757,3623,7149,231,133,3914.59,1.9
"2011","DY11 5","DY11 5","Total",9960,4862,5098,9826,134,96,1856.54,5.4
"2011","DY11 6","DY11 6","Total",12434,6130,6304,12307,127,114,337.24,36.9
"2011","DY11 7","DY11 7","Total",7683,3853,3830,7650,33,71,755.07,10.2
"2011","DY12 1","DY12 1","Total",4960,2459,2501,4959,1,84,2424.76,2.0
"2011","DY12 2","DY12 2","Total",5976,2965,3011,5932,44,110,2761.89,2.2
"2011","DY12 3","DY12 3","Total",1369,705,664,1302,67,7,4369.68,0.3
"2011","DY13 0","DY13 0","Total",6755,3291,3464,6671,84,63,1837.02,3.7
"2011","DY13 8","DY13 8","Total",8832,4275,4557,8736,96,67,557.89,15.8
"2011","DY13 9","DY13 9","Total",6622,3284,3338,6603,19,71,2007.22,3.3
"2011","DY14 0","DY14 0","Total",1775,909,866,1742,33,38,5726.65,0.3
"2011","DY14 8","DY14 8","Total",3843,1936,1907,3792,51,67,5469.46,0.7
"2011","DY14 9","DY14 9","Total",2911,1434,1477,2891,20,45,4195.62,0.7
"2011","DY2  0","DY2  0","Total",11024,5494,5530,11015,9,40,391.72,28.1
"2011","DY2  7","DY2  7","Total",7648,3681,3967,7618,30,46,157.27,48.6
"2011","DY2  8","DY2  8","Total",7069,3472,3597,7032,37,48,210.77,33.5
"2011","DY2  9","DY2  9","Total",8720,4341,4379,8553,167,37,240.76,36.2
"2011","DY3  1","DY3  1","Total",9578,4628,4950,9451,127,54,267.13,35.9
"2011","DY3  2","DY3  2","Total",11240,5544,5696,11234,6,66,325.12,34.6
"2011","DY3  3","DY3  3","Total",11109,5414,5695,11072,37,86,362.75,30.6
"2011","DY3  4","DY3  4","Total",1803,863,940,1683,120,13,1666.02,1.1
"2011","DY4  0","DY4  0","Total",13881,6973,6908,13770,111,38,320.77,43.3
"2011","DY4  7","DY4  7","Total",9825,4829,4996,9738,87,35,223.09,44.0
"2011","DY4  8","DY4  8","Total",11217,5509,5708,11138,79,50,254.01,44.2
"2011","DY4  9","DY4  9","Total",7923,3881,4042,7850,73,23,215.44,36.8
"2011","DY5  1","DY5  1","Total",6453,3174,3279,6389,64,33,274.36,23.5
"2011","DY5  2","DY5  2","Total",13659,6873,6786,13654,5,93,331.47,41.2
"2011","DY5  3","DY5  3","Total",13053,6442,6611,13025,28,112,331.74,39.3
"2011","DY5  4","DY5  4","Total",8733,4287,4446,8676,57,41,341.84,25.5
"2011","DY6  0","DY6  0","Total",4060,1971,2089,3980,80,55,125.14,32.4
"2011","DY6  7","DY6  7","Total",4124,1999,2125,4064,60,42,199.96,20.6
"2011","DY6  8","DY6  8","Total",10735,5323,5412,10719,16,84,377.73,28.4
"2011","DY6  9","DY6  9","Total",8570,4168,4402,8501,69,107,230.60,37.2
"2011","DY7  5","DY7  5","Total",2208,1073,1135,2103,105,44,5606.27,0.4
"2011","DY7  6","DY7  6","Total",6092,2938,3154,6039,53,131,1691.29,3.6
"2011","DY8  1","DY8  1","Total",5551,2981,2570,5146,405,102,131.06,42.4
"2011","DY8  2","DY8  2","Total",6038,2927,3111,5965,73,127,455.80,13.2
"2011","DY8  3","DY8  3","Total",12558,6119,6439,12480,78,183,380.71,33.0
"2011","DY8  4","DY8  4","Total",13351,6460,6891,13204,147,105,318.41,41.9
"2011","DY8  5","DY8  5","Total",13239,6476,6763,13092,147,112,279.44,47.4
"2011","DY9  0","DY9  0","Total",10867,5214,5653,10739,128,230,1112.79,9.8
"2011","DY9  7","DY9  7","Total",4985,2468,2517,4985,0,31,155.20,32.1
"2011","DY9  8","DY9  8","Total",5929,2948,2981,5837,92,45,153.17,38.7
"2011","DY9  9","DY9  9","Total",8291,4131,4160,8122,169,100,2706.60,3.1
"2011","E1   0","E1   0","Total",11066,5667,5399,11024,42,57,69.47,159.3
"2011","E1   1","E1   1","Total",6305,3494,2811,6293,12,41,28.30,222.8
"2011","E1   2","E1   2","Total",7872,4074,3798,7671,201,46,48.56,162.1
"2011","E1   3","E1   3","Total",7366,3748,3618,7188,178,35,44.58,165.2
"2011","E1   4","E1   4","Total",15388,7654,7734,13897,1491,147,94.47,162.9
"2011","E1   5","E1   5","Total",11202,5922,5280,10677,525,66,67.83,165.1
"2011","E1   6","E1   6","Total",4333,2442,1891,4042,291,26,52.82,82.0
"2011","E1   7","E1   7","Total",2483,1383,1100,2354,129,46,96.39,25.8
"2011","E1   8","E1   8","Total",4374,2399,1975,4374,0,24,48.74,89.7
"2011","E10  5","E10  5","Total",14857,7328,7529,14825,32,91,185.52,80.1
"2011","E10  6","E10  6","Total",16361,8369,7992,16343,18,94,135.51,120.7
"2011","E10  7","E10  7","Total",11902,6053,5849,11842,60,50,250.05,47.6
"2011","E11  1","E11  1","Total",11673,6103,5570,11422,251,121,221.24,52.8
"2011","E11  2","E11  2","Total",11440,5432,6008,11278,162,166,246.91,46.3
"2011","E11  3","E11  3","Total",16434,8425,8009,16348,86,160,242.14,67.9
"2011","E11  4","E11  4","Total",15142,7704,7438,15040,102,124,123.23,122.9
"2011","E12  5","E12  5","Total",16644,8481,8163,16440,204,200,395.61,42.1
"2011","E12  6","E12  6","Total",25962,13906,12056,25948,14,190,172.37,150.6
"2011","E13  0","E13  0","Total",19094,10038,9056,19057,37,142,126.80,150.6
"2011","E13  8","E13  8","Total",13717,6909,6808,13693,24,119,124.15,110.5
"2011","E13  9","E13  9","Total",14358,7515,6843,14310,48,110,92.67,154.9
"2011","E14  0","E14  0","Total",10795,5335,5460,10794,1,78,90.07,119.9
"2011","E14  2","E14  2","Total",1760,930,830,1760,0,15,38.06,46.2
"2011","E14  3","E14  3","Total",17059,8789,8270,17059,0,81,135.08,126.3
"2011","E14  4","E14  4","Total",468,288,180,468,0,6,32.25,14.5
"2011","E14  5","E14  5","Total",649,353,296,649,0,1,11.76,55.2
"2011","E14  6","E14  6","Total",12181,6141,6040,12084,97,91,83.56,145.8
"2011","E14  7","E14  7","Total",12828,6604,6224,12812,16,51,85.32,150.4
"2011","E14  8","E14  8","Total",12380,6514,5866,12305,75,69,90.45,136.9
"2011","E14  9","E14  9","Total",14518,7884,6634,14518,0,67,138.72,104.7
"2011","E15  1","E15  1","Total",13928,7149,6779,13904,24,102,233.32,59.7
"2011","E15  2","E15  2","Total",10963,5766,5197,10918,45,57,236.66,46.3
"2011","E15  3","E15  3","Total",14417,7384,7033,14413,4,96,124.36,115.9
"2011","E15  4","E15  4","Total",12342,6343,5999,12255,87,76,107.06,115.3
"2011","E16  1","E16  1","Total",11995,6337,5658,11995,0,91,196.47,61.1
"2011","E16  2","E16  2","Total",9795,4927,4868,9096,699,98,310.34,31.6
"2011","E16  3","E16  3","Total",14011,6839,7172,13995,16,119,199.05,70.4
"2011","E16  4","E16  4","Total",9570,4643,4927,9534,36,92,170.90,56.0
"2011","E17  3","E17  3","Total",12624,6232,6392,12288,336,117,168.38,75.0
"2011","E17  4","E17  4","Total",16479,8318,8161,16390,89,134,223.44,73.8
"2011","E17  5","E17  5","Total",17002,8321,8681,17002,0,133,259.67,65.5
"2011","E17  6","E17  6","Total",17015,8762,8253,17003,12,115,282.58,60.2
"2011","E17  7","E17  7","Total",11177,5663,5514,11172,5,63,231.49,48.3
"2011","E17  8","E17  8","Total",15726,7908,7818,15635,91,88,162.38,96.8
"2011","E17  9","E17  9","Total",13106,6395,6711,12988,118,93,109.30,119.9
"2011","E18  1","E18  1","Total",7920,3886,4034,7896,24,96,147.64,53.6
"2011","E18  2","E18  2","Total",11944,5771,6173,11902,42,171,168.14,71.0
"2011","E1W  1","E1W  1","Total",2506,1379,1127,2506,0,12,33.46,74.9
"2011","E1W  2","E1W  2","Total",4204,2351,1853,4137,67,32,41.69,100.8
"2011","E1W  3","E1W  3","Total",5718,3028,2690,5718,0,24,31.04,184.2
"2011","E2   0","E2   0","Total",11253,5656,5597,11222,31,67,62.04,181.4
"2011","E2   6","E2   6","Total",9423,4830,4593,9086,337,38,53.49,176.2
"2011","E2   7","E2   7","Total",9106,4701,4405,9076,30,38,47.07,193.5
"2011","E2   8","E2   8","Total",7539,3809,3730,7526,13,39,56.20,134.1
"2011","E2   9","E2   9","Total",8490,4224,4266,8416,74,53,56.46,150.4
"2011","E3   2","E3   2","Total",13970,6931,7039,13969,1,84,162.70,85.9
"2011","E3   3","E3   3","Total",10681,5446,5235,10661,20,75,80.94,132.0
"2011","E3   4","E3   4","Total",15169,7715,7454,15043,126,70,127.20,119.3
"2011","E3   5","E3   5","Total",12551,6172,6379,12529,22,82,119.70,104.9
"2011","E4   6","E4   6","Total",16960,8069,8891,16810,150,202,330.78,51.3
"2011","E4   7","E4   7","Total",11697,5652,6045,11544,153,135,977.39,12.0
"2011","E4   8","E4   8","Total",14418,6938,7480,14344,74,136,259.42,55.6
"2011","E4   9","E4   9","Total",17282,8387,8895,17200,82,229,274.96,62.9
"2011","E5   0","E5   0","Total",17276,8423,8853,17149,127,141,129.11,133.8
"2011","E5   8","E5   8","Total",16080,7900,8180,16021,59,106,109.89,146.3
"2011","E5   9","E5   9","Total",15136,7457,7679,15086,50,194,122.44,123.6
"2011","E6   1","E6   1","Total",16731,9322,7409,16686,45,115,100.61,166.3
"2011","E6   2","E6   2","Total",18102,9789,8313,18099,3,142,152.77,118.5
"2011","E6   3","E6   3","Total",21007,10740,10267,20953,54,156,156.27,134.4
"2011","E6   5","E6   5","Total",11066,5302,5764,11045,21,103,195.47,56.6
"2011","E6   6","E6   6","Total",11884,5864,6020,11792,92,116,446.79,26.6
"2011","E7   0","E7   0","Total",14800,7710,7090,14607,193,146,116.41,127.1
"2011","E7   8","E7   8","Total",21075,11668,9407,21011,64,160,109.58,192.3
"2011","E7   9","E7   9","Total",18258,9705,8553,17935,323,154,124.35,146.8
"2011","E8   1","E8   1","Total",8368,4081,4287,8368,0,51,58.88,142.1
"2011","E8   2","E8   2","Total",10061,5132,4929,9986,75,80,61.38,163.9
"2011","E8   3","E8   3","Total",10444,5114,5330,10424,20,81,81.51,128.1
"2011","E8   4","E8   4","Total",10387,5175,5212,10387,0,83,73.44,141.4
"2011","E9   5","E9   5","Total",12702,6152,6550,12605,97,122,290.24,43.8
"2011","E9   6","E9   6","Total",11561,5716,5845,11464,97,87,77.80,148.6
"2011","E9   7","E9   7","Total",13505,6554,6951,13377,128,139,85.95,157.1
"2011","EC1A 4","EC1A 4","Total",143,53,90,143,0,8,0.38,376.3
"2011","EC1A 7","EC1A 7","Total",393,237,156,363,30,2,30.64,12.8
"2011","EC1A 9","EC1A 9","Total",358,217,141,338,20,2,8.62,41.5
"2011","EC1M 3","EC1M 3","Total",428,225,203,418,10,1,3.19,134.2
"2011","EC1M 5","EC1M 5","Total",1105,628,477,880,225,5,13.45,82.2
"2011","EC1M 6","EC1M 6","Total",753,388,365,292,461,6,6.95,108.3
"2011","EC1M 7","EC1M 7","Total",187,85,102,187,0,0,1.28,146.1
"2011","EC1N 7","EC1N 7","Total",2011,1047,964,1978,33,7,12.52,160.6
"2011","EC1N 8","EC1N 8","Total",639,350,289,571,68,12,8.33,76.7
"2011","EC1R 0","EC1R 0","Total",1225,628,597,1225,0,9,13.64,89.8
"2011","EC1R 1","EC1R 1","Total",1239,662,577,1030,209,13,10.27,120.6
"2011","EC1R 3","EC1R 3","Total",298,139,159,298,0,4,3.95,75.4
"2011","EC1R 4","EC1R 4","Total",1422,745,677,1422,0,14,11.06,128.6
"2011","EC1R 5","EC1R 5","Total",701,390,311,701,0,4,7.21,97.2
"2011","EC1V 0","EC1V 0","Total",2106,1068,1038,2106,0,20,11.47,183.6
"2011","EC1V 1","EC1V 1","Total",223,106,117,223,0,1,1.49,149.7
"2011","EC1V 2","EC1V 2","Total",121,77,44,121,0,0,2.72,44.5
"2011","EC1V 3","EC1V 3","Total",3194,1608,1586,2539,655,35,18.48,172.8
"2011","EC1V 4","EC1V 4","Total",1342,701,641,1208,134,10,5.95,225.5
"2011","EC1V 7","EC1V 7","Total",2333,1228,1105,2324,9,25,16.21,143.9
"2011","EC1V 8","EC1V 8","Total",1711,860,851,1710,1,28,10.31,166.0
"2011","EC1V 9","EC1V 9","Total",1735,865,870,1680,55,19,10.21,169.9
"2011","EC1Y 0","EC1Y 0","Total",1216,603,613,1204,12,6,5.34,227.7
"2011","EC1Y 2","EC1Y 2","Total",204,139,65,204,0,0,4.25,48.0
"2011","EC1Y 4","EC1Y 4","Total",325,157,168,149,176,2,12.92,25.2
"2011","EC1Y 8","EC1Y 8","Total",2022,1067,955,1898,124,13,10.15,199.2
"2011","EC2A 3","EC2A 3","Total",483,302,181,483,0,1,4.35,111.0
"2011","EC2A 4","EC2A 4","Total",746,433,313,746,0,0,20.58,36.2
"2011","EC2Y 8","EC2Y 8","Total",3249,1727,1522,3165,84,47,31.18,104.2
"2011","EC3R 8","EC3R 8","Total",227,149,78,227,0,5,33.92,6.7
"2011","EC4A 1","EC4A 1","Total",151,90,61,151,0,0,7.86,19.2
"2011","EC4V 3","EC4V 3","Total",319,180,139,319,0,1,23.19,13.8
"2011","EC4V 5","EC4V 5","Total",276,177,99,235,41,3,26.72,10.3
"2011","EC4Y 7","EC4Y 7","Total",320,196,124,320,0,5,23.96,13.4
"2011","EN1  1","EN1  1","Total",12238,5934,6304,12210,28,125,169.68,72.1
"2011","EN1  2","EN1  2","Total",7094,3442,3652,6974,120,129,110.01,64.5
"2011","EN1  3","EN1  3","Total",12261,5867,6394,12165,96,172,267.79,45.8
"2011","EN1  4","EN1  4","Total",13404,6394,7010,13292,112,130,286.35,46.8
"2011","EN10 6","EN10 6","Total",10904,5245,5659,10815,89,103,611.03,17.8
"2011","EN10 7","EN10 7","Total",6132,3015,3117,6097,35,115,533.55,11.5
"2011","EN11 0","EN11 0","Total",6488,3184,3304,6487,1,38,378.56,17.1
"2011","EN11 8","EN11 8","Total",6633,3269,3364,6610,23,53,707.36,9.4
"2011","EN11 9","EN11 9","Total",8330,4062,4268,8259,71,102,171.78,48.5
"2011","EN2  0","EN2  0","Total",9548,4543,5005,9541,7,133,150.86,63.3
"2011","EN2  6","EN2  6","Total",4241,2110,2131,4190,51,49,125.08,33.9
"2011","EN2  7","EN2  7","Total",7240,3456,3784,7183,57,124,351.00,20.6
"2011","EN2  8","EN2  8","Total",7071,3515,3556,6895,176,105,174.85,40.4
"2011","EN2  9","EN2  9","Total",1609,769,840,1558,51,28,1405.62,1.1
"2011","EN3  4","EN3  4","Total",11749,5683,6066,11578,171,128,303.34,38.7
"2011","EN3  5","EN3  5","Total",15971,7583,8388,15932,39,139,213.22,74.9
"2011","EN3  6","EN3  6","Total",19395,9210,10185,19390,5,211,370.98,52.3
"2011","EN3  7","EN3  7","Total",9958,4740,5218,9946,12,94,371.94,26.8
"2011","EN4  0","EN4  0","Total",5253,2522,2731,4935,318,153,773.26,6.8
"2011","EN4  8","EN4  8","Total",12276,5986,6290,12276,0,180,220.06,55.8
"2011","EN4  9","EN4  9","Total",8049,3950,4099,8029,20,153,283.69,28.4
"2011","EN5  1","EN5  1","Total",6783,3342,3441,6724,59,120,118.25,57.4
"2011","EN5  2","EN5  2","Total",13749,6501,7248,13591,158,223,370.48,37.1
"2011","EN5  3","EN5  3","Total",3505,1623,1882,3391,114,82,400.24,8.8
"2011","EN5  4","EN5  4","Total",5634,2729,2905,5455,179,124,1478.90,3.8
"2011","EN5  5","EN5  5","Total",8400,4010,4390,8356,44,146,295.89,28.4
"2011","EN6  1","EN6  1","Total",6386,2964,3422,6309,77,127,371.00,17.2
"2011","EN6  2","EN6  2","Total",6924,3238,3686,6853,71,114,311.82,22.2
"2011","EN6  3","EN6  3","Total",5390,2583,2807,5388,2,78,1650.71,3.3
"2011","EN6  4","EN6  4","Total",5181,2567,2614,5180,1,139,1542.64,3.4
"2011","EN6  5","EN6  5","Total",5129,2426,2703,5058,71,63,159.73,32.1
"2011","EN7  5","EN7  5","Total",7447,3624,3823,7438,9,76,1298.03,5.7
"2011","EN7  6","EN7  6","Total",14603,7063,7540,14549,54,162,913.95,16.0
"2011","EN8  0","EN8  0","Total",9579,4571,5008,9579,0,81,228.03,42.0
"2011","EN8  7","EN8  7","Total",6936,3380,3556,6936,0,39,227.07,30.5
"2011","EN8  8","EN8  8","Total",11174,5254,5920,11127,47,104,254.89,43.8
"2011","EN8  9","EN8  9","Total",8137,3973,4164,8084,53,95,213.04,38.2
"2011","EN9  1","EN9  1","Total",7754,3766,3988,7754,0,69,388.59,20.0
"2011","EN9  2","EN9  2","Total",4799,2390,2409,4799,0,59,2862.01,1.7
"2011","EN9  3","EN9  3","Total",11080,5416,5664,10825,255,65,1385.24,8.0
"2011","EX1  1","EX1  1","Total",1726,870,856,1405,321,19,38.41,44.9
"2011","EX1  2","EX1  2","Total",9195,4556,4639,8727,468,124,142.13,64.7
"2011","EX1  3","EX1  3","Total",10600,5081,5519,10563,37,116,661.70,16.0
"2011","EX10 0","EX10 0","Total",4638,2239,2399,4514,124,185,7014.31,0.7
"2011","EX10 8","EX10 8","Total",3420,1494,1926,3215,205,54,383.86,8.9
"2011","EX10 9","EX10 9","Total",9149,4231,4918,8996,153,113,1019.79,9.0
"2011","EX11 1","EX11 1","Total",7795,3733,4062,7730,65,146,3213.48,2.4
"2011","EX12 2","EX12 2","Total",7096,3260,3836,6902,194,66,475.86,14.9
"2011","EX12 3","EX12 3","Total",1824,896,928,1823,1,29,2086.95,0.9
"2011","EX12 4","EX12 4","Total",496,234,262,496,0,5,1235.40,0.4
"2011","EX13 5","EX13 5","Total",6997,3341,3656,6879,118,70,3270.59,2.1
"2011","EX13 7","EX13 7","Total",3789,1862,1927,3781,8,64,7087.01,0.5
"2011","EX13 8","EX13 8","Total",543,260,283,521,22,7,858.41,0.6
"2011","EX14 1","EX14 1","Total",5958,2777,3181,5895,63,64,579.72,10.3
"2011","EX14 2","EX14 2","Total",5525,2624,2901,5493,32,61,716.92,7.7
"2011","EX14 3","EX14 3","Total",3799,1872,1927,3776,23,61,5443.96,0.7
"2011","EX14 4","EX14 4","Total",2461,1224,1237,2420,41,30,5243.01,0.5
"2011","EX14 9","EX14 9","Total",2944,1455,1489,2942,2,54,9419.11,0.3
"2011","EX15 1","EX15 1","Total",8766,4288,4478,8599,167,93,4653.58,1.9
"2011","EX15 2","EX15 2","Total",5881,2891,2990,5851,30,102,6156.81,1.0
"2011","EX15 3","EX15 3","Total",6666,3292,3374,6655,11,102,8445.02,0.8
"2011","EX16 4","EX16 4","Total",6179,3012,3167,5956,223,98,3908.16,1.6
"2011","EX16 5","EX16 5","Total",4920,2397,2523,4895,25,32,1479.85,3.3
"2011","EX16 6","EX16 6","Total",9691,4710,4981,9612,79,87,265.91,36.4
"2011","EX16 7","EX16 7","Total",4384,2170,2214,4364,20,85,7181.14,0.6
"2011","EX16 8","EX16 8","Total",3909,1957,1952,3885,24,66,14507.40,0.3
"2011","EX16 9","EX16 9","Total",3357,1632,1725,3293,64,69,11384.25,0.3
"2011","EX17 1","EX17 1","Total",2185,1087,1098,2185,0,31,1816.55,1.2
"2011","EX17 2","EX17 2","Total",2176,1011,1165,2124,52,23,63.53,34.3
"2011","EX17 3","EX17 3","Total",4362,2180,2182,4263,99,63,1935.21,2.3
"2011","EX17 4","EX17 4","Total",3273,1628,1645,3260,13,68,10987.70,0.3
"2011","EX17 5","EX17 5","Total",3320,1647,1673,3294,26,57,7788.38,0.4
"2011","EX17 6","EX17 6","Total",4223,2044,2179,4204,19,45,8586.83,0.5
"2011","EX18 7","EX18 7","Total",3117,1531,1586,3091,26,64,12692.91,0.2
"2011","EX19 8","EX19 8","Total",3525,1740,1785,3501,24,50,9227.99,0.4
"2011","EX2  4","EX2  4","Total",6190,2931,3259,6036,154,122,150.05,41.3
"2011","EX2  5","EX2  5","Total",8864,4309,4555,8573,291,82,216.26,41.0
"2011","EX2  6","EX2  6","Total",5456,2613,2843,5379,77,44,308.89,17.7
"2011","EX2  7","EX2  7","Total",5196,2530,2666,5173,23,44,468.41,11.1
"2011","EX2  8","EX2  8","Total",7809,3823,3986,7538,271,58,1149.86,6.8
"2011","EX2  9","EX2  9","Total",7183,3463,3720,7148,35,88,2011.46,3.6
"2011","EX20 1","EX20 1","Total",7898,3853,4045,7783,115,73,2256.99,3.5
"2011","EX20 2","EX20 2","Total",4542,2271,2271,4518,24,74,11636.60,0.4
"2011","EX20 3","EX20 3","Total",4457,2205,2252,4354,103,83,16068.71,0.3
"2011","EX20 4","EX20 4","Total",3069,1521,1548,2997,72,45,17791.66,0.2
"2011","EX21 5","EX21 5","Total",4620,2279,2341,4467,153,71,18937.03,0.2
"2011","EX22 6","EX22 6","Total",5939,2912,3027,5786,153,54,14647.67,0.4
"2011","EX22 7","EX22 7","Total",4806,2388,2418,4753,53,77,19170.82,0.3
"2011","EX23 0","EX23 0","Total",3460,1660,1800,3345,115,57,7522.03,0.5
"2011","EX23 8","EX23 8","Total",7401,3564,3837,7276,125,101,636.89,11.6
"2011","EX23 9","EX23 9","Total",4843,2405,2438,4758,85,82,10118.02,0.5
"2011","EX24 6","EX24 6","Total",3789,1799,1990,3748,41,85,5470.77,0.7
"2011","EX3  0","EX3  0","Total",4940,2267,2673,4927,13,97,1022.88,4.8
"2011","EX31 1","EX31 1","Total",3560,1740,1820,3553,7,46,142.02,25.1
"2011","EX31 2","EX31 2","Total",6325,3019,3306,6216,109,76,754.94,8.4
"2011","EX31 3","EX31 3","Total",8170,3915,4255,8166,4,104,6429.46,1.3
"2011","EX31 4","EX31 4","Total",7420,3857,3563,6792,628,154,18727.16,0.4
"2011","EX32 0","EX32 0","Total",5336,2612,2724,5214,122,79,8738.37,0.6
"2011","EX32 7","EX32 7","Total",6937,3372,3565,6860,77,67,4596.24,1.5
"2011","EX32 8","EX32 8","Total",6266,3003,3263,6255,11,49,118.53,52.9
"2011","EX32 9","EX32 9","Total",5239,2511,2728,5154,85,89,183.28,28.6
"2011","EX33 1","EX33 1","Total",5362,2596,2766,5335,27,90,4054.57,1.3
"2011","EX33 2","EX33 2","Total",4862,2334,2528,4766,96,83,1868.88,2.6
"2011","EX34 0","EX34 0","Total",2687,1294,1393,2672,15,27,1485.46,1.8
"2011","EX34 7","EX34 7","Total",1637,820,817,1601,36,15,1543.10,1.1
"2011","EX34 8","EX34 8","Total",6457,3118,3339,6324,133,76,3152.76,2.0
"2011","EX34 9","EX34 9","Total",6525,3189,3336,6231,294,56,2790.49,2.3
"2011","EX35 6","EX35 6","Total",1647,791,856,1450,197,21,6857.10,0.2
"2011","EX36 3","EX36 3","Total",3920,1907,2013,3806,114,58,16244.99,0.2
"2011","EX36 4","EX36 4","Total",4557,2196,2361,4531,26,69,8065.63,0.6
"2011","EX37 9","EX37 9","Total",3362,1655,1707,3334,28,62,11845.64,0.3
"2011","EX38 7","EX38 7","Total",4488,2135,2353,4422,66,56,4234.66,1.1
"2011","EX38 8","EX38 8","Total",3644,1785,1859,3585,59,33,5790.12,0.6
"2011","EX39 1","EX39 1","Total",9389,4510,4879,9258,131,91,851.10,11.0
"2011","EX39 2","EX39 2","Total",3760,1818,1942,3697,63,33,115.39,32.6
"2011","EX39 3","EX39 3","Total",9009,4373,4636,8787,222,104,689.98,13.1
"2011","EX39 4","EX39 4","Total",6870,3355,3515,6787,83,74,4021.08,1.7
"2011","EX39 5","EX39 5","Total",6224,3054,3170,6158,66,89,12769.53,0.5
"2011","EX39 6","EX39 6","Total",1911,960,951,1903,8,35,7728.51,0.2
"2011","EX4  0","EX4  0","Total",297,145,152,297,0,12,705.30,0.4
"2011","EX4  1","EX4  1","Total",9206,4457,4749,9082,124,90,213.29,43.2
"2011","EX4  2","EX4  2","Total",7726,3777,3949,7654,72,73,2456.37,3.1
"2011","EX4  3","EX4  3","Total",2148,1094,1054,2055,93,7,35.75,60.1
"2011","EX4  4","EX4  4","Total",8928,4581,4347,6327,2601,124,311.67,28.6
"2011","EX4  5","EX4  5","Total",2990,1434,1556,2967,23,40,446.64,6.7
"2011","EX4  6","EX4  6","Total",8172,3838,4334,6780,1392,116,109.06,74.9
"2011","EX4  7","EX4  7","Total",5260,2652,2608,5251,9,62,88.86,59.2
"2011","EX4  8","EX4  8","Total",6261,2953,3308,6240,21,55,246.74,25.4
"2011","EX4  9","EX4  9","Total",3723,1813,1910,3723,0,28,296.81,12.5
"2011","EX5  1","EX5  1","Total",3521,1705,1816,3517,4,92,2845.26,1.2
"2011","EX5  2","EX5  2","Total",4779,2309,2470,4757,22,72,6227.25,0.8
"2011","EX5  3","EX5  3","Total",2353,1157,1196,2282,71,57,3494.26,0.7
"2011","EX5  4","EX5  4","Total",5055,2418,2637,5032,23,81,3106.57,1.6
"2011","EX5  5","EX5  5","Total",2860,1382,1478,2833,27,54,5932.66,0.5
"2011","EX6  6","EX6  6","Total",2793,1376,1417,2789,4,62,6323.19,0.4
"2011","EX6  7","EX6  7","Total",4007,1965,2042,3978,29,104,10833.70,0.4
"2011","EX6  8","EX6  8","Total",6873,3324,3549,6795,78,91,4733.55,1.5
"2011","EX7  0","EX7  0","Total",5664,2729,2935,5496,168,78,1784.51,3.2
"2011","EX7  9","EX7  9","Total",6768,3140,3628,6526,242,65,250.09,27.1
"2011","EX8  1","EX8  1","Total",7109,3440,3669,6981,128,64,105.32,67.5
"2011","EX8  2","EX8  2","Total",7664,3509,4155,7340,324,91,377.12,20.3
"2011","EX8  3","EX8  3","Total",5540,2578,2962,5478,62,77,239.15,23.2
"2011","EX8  4","EX8  4","Total",9532,4522,5010,9477,55,83,457.52,20.8
"2011","EX8  5","EX8  5","Total",7604,4093,3511,6647,957,114,1193.50,6.4
"2011","EX9  6","EX9  6","Total",5185,2353,2832,5062,123,62,434.77,11.9
"2011","EX9  7","EX9  7","Total",1578,735,843,1559,19,24,2498.49,0.6
"2011","FY1  1","FY1  1","Total",294,193,101,221,73,0,13.44,21.9
"2011","FY1  2","FY1  2","Total",7870,4186,3684,7413,457,33,123.01,64.0
"2011","FY1  3","FY1  3","Total",4412,2284,2128,4374,38,20,68.37,64.5
"2011","FY1  4","FY1  4","Total",6528,3440,3088,5663,865,32,98.40,66.3
"2011","FY1  5","FY1  5","Total",6129,3113,3016,5929,200,37,102.59,59.7
"2011","FY1  6","FY1  6","Total",8401,4229,4172,7875,526,43,118.65,70.8
"2011","FY2  0","FY2  0","Total",14413,6929,7484,14397,16,122,415.19,34.7
"2011","FY2  9","FY2  9","Total",10146,5050,5096,9651,495,90,209.61,48.4
"2011","FY3  0","FY3  0","Total",1932,927,1005,1932,0,46,592.80,3.3
"2011","FY3  7","FY3  7","Total",10503,5038,5465,10462,41,78,230.28,45.6
"2011","FY3  8","FY3  8","Total",9532,4681,4851,9370,162,87,226.92,42.0
"2011","FY3  9","FY3  9","Total",9988,4796,5192,9872,116,108,476.50,21.0
"2011","FY4  1","FY4  1","Total",8507,4224,4283,7701,806,68,177.06,48.0
"2011","FY4  2","FY4  2","Total",7805,3775,4030,7704,101,66,130.76,59.7
"2011","FY4  3","FY4  3","Total",10358,4952,5406,10295,63,58,170.41,60.8
"2011","FY4  4","FY4  4","Total",11958,5753,6205,11949,9,87,300.42,39.8
"2011","FY4  5","FY4  5","Total",5036,2383,2653,5024,12,47,721.69,7.0
"2011","FY5  1","FY5  1","Total",7947,3869,4078,7690,257,69,182.33,43.6
"2011","FY5  2","FY5  2","Total",12093,5752,6341,12048,45,128,395.07,30.6
"2011","FY5  3","FY5  3","Total",11154,5256,5898,11131,23,137,300.47,37.1
"2011","FY5  4","FY5  4","Total",8381,4013,4368,8349,32,83,415.37,20.2
"2011","FY5  5","FY5  5","Total",5241,2493,2748,5208,33,80,368.91,14.2
"2011","FY6  0","FY6  0","Total",7177,3492,3685,7104,73,74,2444.58,2.9
"2011","FY6  7","FY6  7","Total",12715,6143,6572,12550,165,203,1032.80,12.3
"2011","FY6  8","FY6  8","Total",5367,2556,2811,5367,0,110,1081.39,5.0
"2011","FY6  9","FY6  9","Total",2744,1328,1416,2619,125,29,605.06,4.5
"2011","FY7  6","FY7  6","Total",6830,3452,3378,6774,56,49,432.23,15.8
"2011","FY7  7","FY7  7","Total",8967,4279,4688,8921,46,67,146.58,61.2
"2011","FY7  8","FY7  8","Total",10142,4925,5217,9636,506,80,401.17,25.3
"2011","FY8  1","FY8  1","Total",9332,4583,4749,8920,412,149,315.93,29.5
"2011","FY8  2","FY8  2","Total",8790,4283,4507,8624,166,142,545.18,16.1
"2011","FY8  3","FY8  3","Total",9816,4631,5185,9800,16,102,561.52,17.5
"2011","FY8  4","FY8  4","Total",10136,4824,5312,10127,9,226,1514.50,6.7
"2011","FY8  5","FY8  5","Total",5979,2810,3169,5675,304,81,1046.26,5.7
"2011","GL1  1","GL1  1","Total",1920,1108,812,1861,59,12,53.73,35.7
"2011","GL1  2","GL1  2","Total",3794,2000,1794,3527,267,25,347.18,10.9
"2011","GL1  3","GL1  3","Total",5846,3016,2830,5460,386,46,203.03,28.8
"2011","GL1  4","GL1  4","Total",11963,5975,5988,11936,27,80,146.65,81.6
"2011","GL1  5","GL1  5","Total",10629,5303,5326,10492,137,128,235.31,45.2
"2011","GL10 2","GL10 2","Total",6858,3404,3454,6555,303,87,409.45,16.7
"2011","GL10 3","GL10 3","Total",7095,3501,3594,7045,50,111,5536.12,1.3
"2011","GL11 4","GL11 4","Total",6187,3054,3133,6095,92,74,397.05,15.6
"2011","GL11 5","GL11 5","Total",8033,3988,4045,8030,3,135,2474.59,3.2
"2011","GL11 6","GL11 6","Total",3919,1907,2012,3873,46,85,2454.74,1.6
"2011","GL12 7","GL12 7","Total",6328,3097,3231,6267,61,143,3593.22,1.8
"2011","GL12 8","GL12 8","Total",8717,4504,4213,7903,814,166,6461.93,1.3
"2011","GL13 9","GL13 9","Total",5863,2917,2946,5824,39,88,7151.40,0.8
"2011","GL14 1","GL14 1","Total",3804,1920,1884,3666,138,83,5870.60,0.6
"2011","GL14 2","GL14 2","Total",8039,3920,4119,7999,40,48,2577.90,3.1
"2011","GL14 3","GL14 3","Total",3879,1956,1923,3861,18,27,740.13,5.2
"2011","GL15 4","GL15 4","Total",4988,2452,2536,4930,58,57,3520.20,1.4
"2011","GL15 5","GL15 5","Total",8776,4260,4516,8702,74,88,2089.89,4.2
"2011","GL15 6","GL15 6","Total",6979,3446,3533,6978,1,103,5742.70,1.2
"2011","GL16 7","GL16 7","Total",7116,3500,3616,7104,12,78,2538.76,2.8
"2011","GL16 8","GL16 8","Total",6265,3047,3218,6168,97,78,2916.22,2.1
"2011","GL17 0","GL17 0","Total",4537,2212,2325,4385,152,51,3064.98,1.5
"2011","GL17 9","GL17 9","Total",6643,3324,3319,6594,49,54,1888.35,3.5
"2011","GL18 1","GL18 1","Total",5999,2907,3092,5925,74,92,4556.44,1.3
"2011","GL18 2","GL18 2","Total",1494,750,744,1470,24,36,3843.47,0.4
"2011","GL19 3","GL19 3","Total",6644,3227,3417,5742,902,151,8016.07,0.8
"2011","GL19 4","GL19 4","Total",3159,1579,1580,3135,24,94,7001.32,0.5
"2011","GL2  0","GL2  0","Total",12031,5880,6151,11849,182,186,291.15,41.3
"2011","GL2  2","GL2  2","Total",4975,2463,2512,4974,1,64,226.59,22.0
"2011","GL2  3","GL2  3","Total",504,249,255,504,0,13,1489.41,0.3
"2011","GL2  4","GL2  4","Total",15690,7663,8027,15552,138,146,1133.39,13.8
"2011","GL2  5","GL2  5","Total",3698,1793,1905,3697,1,40,469.26,7.9
"2011","GL2  7","GL2  7","Total",4760,2373,2387,4688,72,97,5200.95,0.9
"2011","GL2  8","GL2  8","Total",3662,1754,1908,3590,72,91,4250.26,0.9
"2011","GL2  9","GL2  9","Total",6499,3242,3257,6243,256,130,2538.24,2.6
"2011","GL20 5","GL20 5","Total",7139,3526,3613,7118,21,68,381.32,18.7
"2011","GL20 6","GL20 6","Total",2835,1405,1430,2654,181,68,4308.55,0.7
"2011","GL20 7","GL20 7","Total",7412,3620,3792,7410,2,120,4030.04,1.8
"2011","GL20 8","GL20 8","Total",10847,5504,5343,10728,119,137,3925.93,2.8
"2011","GL3  1","GL3  1","Total",6039,2997,3042,5804,235,87,566.07,10.7
"2011","GL3  2","GL3  2","Total",7419,3628,3791,7383,36,138,776.37,9.6
"2011","GL3  3","GL3  3","Total",8442,4046,4396,8414,28,108,511.61,16.5
"2011","GL3  4","GL3  4","Total",8592,4143,4449,8456,136,104,2038.26,4.2
"2011","GL4  0","GL4  0","Total",12327,5980,6347,12237,90,97,1552.59,7.9
"2011","GL4  3","GL4  3","Total",3248,1614,1634,3204,44,53,219.42,14.8
"2011","GL4  4","GL4  4","Total",10405,5093,5312,10385,20,116,243.55,42.7
"2011","GL4  5","GL4  5","Total",8878,4373,4505,8873,5,134,170.94,51.9
"2011","GL4  6","GL4  6","Total",10413,5033,5380,10266,147,81,492.18,21.2
"2011","GL4  8","GL4  8","Total",2537,1253,1284,2510,27,68,3548.21,0.7
"2011","GL5  1","GL5  1","Total",7953,3927,4026,7878,75,110,459.50,17.3
"2011","GL5  2","GL5  2","Total",4534,2314,2220,4466,68,87,670.47,6.8
"2011","GL5  3","GL5  3","Total",4357,2137,2220,4355,2,73,182.21,23.9
"2011","GL5  4","GL5  4","Total",10516,5193,5323,10411,105,108,365.48,28.8
"2011","GL5  5","GL5  5","Total",3680,1802,1878,3653,27,110,1241.03,3.0
"2011","GL50 1","GL50 1","Total",1007,562,445,956,51,14,29.13,34.6
"2011","GL50 2","GL50 2","Total",8317,4152,4165,7777,540,178,160.88,51.7
"2011","GL50 3","GL50 3","Total",4247,1875,2372,3394,853,29,68.09,62.4
"2011","GL50 4","GL50 4","Total",8925,4328,4597,8770,155,108,346.26,25.8
"2011","GL51 0","GL51 0","Total",11984,5818,6166,11861,123,79,1463.43,8.2
"2011","GL51 3","GL51 3","Total",10060,4839,5221,10042,18,146,226.53,44.4
"2011","GL51 4","GL51 4","Total",2413,1149,1264,2337,76,38,1359.32,1.8
"2011","GL51 6","GL51 6","Total",7961,3897,4064,7589,372,148,423.77,18.8
"2011","GL51 7","GL51 7","Total",6501,3182,3319,6409,92,50,105.02,61.9
"2011","GL51 8","GL51 8","Total",6893,3526,3367,6802,91,68,162.84,42.3
"2011","GL51 9","GL51 9","Total",5708,2773,2935,5543,165,54,1406.46,4.1
"2011","GL52 2","GL52 2","Total",4640,2427,2213,4619,21,37,84.25,55.1
"2011","GL52 3","GL52 3","Total",5567,2615,2952,5242,325,116,1560.80,3.6
"2011","GL52 5","GL52 5","Total",8768,4250,4518,8751,17,94,1411.98,6.2
"2011","GL52 6","GL52 6","Total",9425,4688,4737,9304,121,186,695.75,13.5
"2011","GL52 7","GL52 7","Total",1538,731,807,1538,0,34,1062.85,1.4
"2011","GL52 8","GL52 8","Total",9509,4505,5004,9463,46,129,719.40,13.2
"2011","GL52 9","GL52 9","Total",3818,1843,1975,3818,0,98,1610.83,2.4
"2011","GL53 0","GL53 0","Total",4129,1984,2145,4095,34,97,181.59,22.7
"2011","GL53 7","GL53 7","Total",6185,3099,3086,5688,497,152,194.07,31.9
"2011","GL53 8","GL53 8","Total",5344,2530,2814,5226,118,108,477.48,11.2
"2011","GL53 9","GL53 9","Total",4097,1941,2156,3946,151,108,3503.29,1.2
"2011","GL54 1","GL54 1","Total",2982,1414,1568,2914,68,47,4209.62,0.7
"2011","GL54 2","GL54 2","Total",5513,2650,2863,5459,54,121,4556.80,1.2
"2011","GL54 3","GL54 3","Total",3687,1763,1924,3635,52,113,13152.04,0.3
"2011","GL54 4","GL54 4","Total",2905,1467,1438,2900,5,89,9173.26,0.3
"2011","GL54 5","GL54 5","Total",7059,3439,3620,7049,10,155,14726.16,0.5
"2011","GL55 6","GL55 6","Total",5422,2570,2852,5335,87,99,7805.66,0.7
"2011","GL56 0","GL56 0","Total",5159,2444,2715,5113,46,116,6935.34,0.7
"2011","GL56 9","GL56 9","Total",3244,1555,1689,3233,11,58,6156.83,0.5
"2011","GL6  0","GL6  0","Total",6366,3049,3317,6270,96,117,1809.96,3.5
"2011","GL6  6","GL6  6","Total",3986,1905,2081,3985,1,90,1456.84,2.7
"2011","GL6  7","GL6  7","Total",3775,1841,1934,3775,0,134,7246.75,0.5
"2011","GL6  8","GL6  8","Total",6627,3237,3390,6614,13,138,2053.00,3.2
"2011","GL6  9","GL6  9","Total",3706,1762,1944,3558,148,86,1525.83,2.4
"2011","GL7  1","GL7  1","Total",13973,6796,7177,13790,183,182,652.03,21.4
"2011","GL7  2","GL7  2","Total",4922,2316,2606,4883,39,90,580.40,8.5
"2011","GL7  3","GL7  3","Total",4675,2272,2403,4643,32,156,8336.87,0.6
"2011","GL7  4","GL7  4","Total",4359,2114,2245,4281,78,87,3511.69,1.2
"2011","GL7  5","GL7  5","Total",7284,3561,3723,7183,101,204,13069.34,0.6
"2011","GL7  6","GL7  6","Total",4833,2421,2412,4340,493,131,7243.20,0.7
"2011","GL7  7","GL7  7","Total",2234,1136,1098,2121,113,111,6582.85,0.3
"2011","GL8  8","GL8  8","Total",8541,4117,4424,8440,101,177,11822.53,0.7
"2011","GL9  1","GL9  1","Total",2667,1320,1347,2634,33,79,6393.77,0.4
"2011","GU1  1","GU1  1","Total",10647,5414,5233,10600,47,146,530.85,20.1
"2011","GU1  2","GU1  2","Total",8898,4332,4566,8794,104,238,470.79,18.9
"2011","GU1  3","GU1  3","Total",4646,2383,2263,4614,32,141,214.94,21.6
"2011","GU1  4","GU1  4","Total",4978,2703,2275,4873,105,48,90.12,55.2
"2011","GU10 1","GU10 1","Total",4581,2227,2354,4567,14,83,1499.46,3.1
"2011","GU10 2","GU10 2","Total",2887,1431,1456,2757,130,120,2482.55,1.2
"2011","GU10 3","GU10 3","Total",4437,2257,2180,4179,258,150,1229.17,3.6
"2011","GU10 4","GU10 4","Total",6553,3238,3315,6513,40,181,1342.19,4.9
"2011","GU10 5","GU10 5","Total",3780,1767,2013,3599,181,115,3344.03,1.1
"2011","GU11 1","GU11 1","Total",6271,3143,3128,6238,33,57,806.88,7.8
"2011","GU11 2","GU11 2","Total",4626,2790,1836,3364,1262,88,883.34,5.2
"2011","GU11 3","GU11 3","Total",12395,6048,6347,12191,204,129,235.08,52.7
"2011","GU12 4","GU12 4","Total",14535,7237,7298,14529,6,98,285.46,50.9
"2011","GU12 5","GU12 5","Total",7763,3848,3915,7706,57,74,547.84,14.2
"2011","GU12 6","GU12 6","Total",9181,4520,4661,9153,28,76,500.51,18.3
"2011","GU14 0","GU14 0","Total",8039,3959,4080,8030,9,101,304.60,26.4
"2011","GU14 6","GU14 6","Total",9418,4722,4696,9153,265,100,421.58,22.3
"2011","GU14 7","GU14 7","Total",6129,3022,3107,6104,25,96,204.04,30.0
"2011","GU14 8","GU14 8","Total",16241,7928,8313,16230,11,195,412.58,39.4
"2011","GU14 9","GU14 9","Total",15167,7454,7713,15167,0,193,323.57,46.9
"2011","GU15 1","GU15 1","Total",9935,4864,5071,9852,83,241,401.61,24.7
"2011","GU15 2","GU15 2","Total",9561,4736,4825,9392,169,207,451.08,21.2
"2011","GU15 3","GU15 3","Total",6729,3374,3355,6606,123,116,268.34,25.1
"2011","GU15 4","GU15 4","Total",8553,4493,4060,7711,842,102,715.40,12.0
"2011","GU16 6","GU16 6","Total",10274,5164,5110,9981,293,170,1196.99,8.6
"2011","GU16 7","GU16 7","Total",2067,1016,1051,1963,104,22,96.62,21.4
"2011","GU16 8","GU16 8","Total",7653,3768,3885,7653,0,141,206.15,37.1
"2011","GU16 9","GU16 9","Total",3773,1866,1907,3750,23,105,103.59,36.4
"2011","GU17 0","GU17 0","Total",7195,3588,3607,7195,0,80,266.60,27.0
"2011","GU17 9","GU17 9","Total",3906,1965,1941,3692,214,43,1154.45,3.4
"2011","GU18 5","GU18 5","Total",6791,3307,3484,6756,35,147,419.06,16.2
"2011","GU19 5","GU19 5","Total",5592,2791,2801,5508,84,89,865.13,6.5
"2011","GU2  4","GU2  4","Total",2782,1378,1404,2710,72,81,207.75,13.4
"2011","GU2  7","GU2  7","Total",10846,5353,5493,7025,3821,233,385.96,28.1
"2011","GU2  8","GU2  8","Total",8305,4179,4126,8301,4,57,182.08,45.6
"2011","GU2  9","GU2  9","Total",12239,6192,6047,11867,372,181,199.38,61.4
"2011","GU20 6","GU20 6","Total",4392,2185,2207,4329,63,150,955.33,4.6
"2011","GU21 2","GU21 2","Total",11651,5780,5871,11563,88,168,480.52,24.2
"2011","GU21 3","GU21 3","Total",11100,5392,5708,11096,4,123,197.83,56.1
"2011","GU21 4","GU21 4","Total",9883,4849,5034,9750,133,258,735.14,13.4
"2011","GU21 5","GU21 5","Total",8575,4384,4191,8564,11,90,228.15,37.6
"2011","GU21 6","GU21 6","Total",2317,1228,1089,2312,5,21,63.99,36.2
"2011","GU21 7","GU21 7","Total",2064,1012,1052,2024,40,34,68.37,30.2
"2011","GU21 8","GU21 8","Total",4148,2043,2105,4148,0,58,99.49,41.7
"2011","GU22 0","GU22 0","Total",6979,3399,3580,6909,70,191,1174.72,5.9
"2011","GU22 7","GU22 7","Total",8866,4475,4391,8684,182,165,367.09,24.2
"2011","GU22 8","GU22 8","Total",9655,4817,4838,9521,134,179,700.85,13.8
"2011","GU22 9","GU22 9","Total",7900,3988,3912,7823,77,109,540.65,14.6
"2011","GU23 6","GU23 6","Total",3842,1885,1957,3799,43,70,2183.73,1.8
"2011","GU23 7","GU23 7","Total",3027,1389,1638,2753,274,73,1099.67,2.8
"2011","GU24 0","GU24 0","Total",4963,2690,2273,4456,507,79,2139.06,2.3
"2011","GU24 8","GU24 8","Total",4224,2059,2165,4162,62,104,2542.97,1.7
"2011","GU24 9","GU24 9","Total",8658,4578,4080,7948,710,186,1818.16,4.8
"2011","GU25 4","GU25 4","Total",5448,2659,2789,5310,138,188,1038.64,5.2
"2011","GU26 6","GU26 6","Total",7475,3583,3892,6913,562,182,1479.59,5.1
"2011","GU27 1","GU27 1","Total",6763,3233,3530,6612,151,158,865.23,7.8
"2011","GU27 2","GU27 2","Total",5039,2398,2641,4999,40,142,585.07,8.6
"2011","GU27 3","GU27 3","Total",5923,2913,3010,5663,260,210,4742.76,1.2
"2011","GU28 0","GU28 0","Total",3772,1778,1994,3573,199,99,5287.08,0.7
"2011","GU28 9","GU28 9","Total",2878,1410,1468,2874,4,81,6172.41,0.5
"2011","GU29 0","GU29 0","Total",3206,1539,1667,3175,31,125,8110.19,0.4
"2011","GU29 9","GU29 9","Total",5888,2728,3160,5824,64,86,410.06,14.4
"2011","GU3  1","GU3  1","Total",2442,1135,1307,2227,215,73,2723.52,0.9
"2011","GU3  2","GU3  2","Total",2416,1197,1219,2410,6,55,1525.99,1.6
"2011","GU3  3","GU3  3","Total",6213,3050,3163,6139,74,127,1579.88,3.9
"2011","GU30 7","GU30 7","Total",9081,4410,4671,8974,107,273,4617.34,2.0
"2011","GU31 4","GU31 4","Total",7643,3613,4030,7602,41,164,590.36,12.9
"2011","GU31 5","GU31 5","Total",3580,1770,1810,3562,18,154,7997.69,0.4
"2011","GU32 1","GU32 1","Total",3312,1633,1679,3248,64,135,7219.99,0.5
"2011","GU32 2","GU32 2","Total",3833,1823,2010,3387,446,119,1071.11,3.6
"2011","GU32 3","GU32 3","Total",4824,2307,2517,4788,36,56,359.76,13.4
"2011","GU33 6","GU33 6","Total",1935,958,977,1907,28,61,3257.89,0.6
"2011","GU33 7","GU33 7","Total",6507,3040,3467,6151,356,125,1502.37,4.3
"2011","GU34 1","GU34 1","Total",6437,3064,3373,6399,38,105,1313.79,4.9
"2011","GU34 2","GU34 2","Total",10206,5021,5185,10045,161,130,382.04,26.7
"2011","GU34 3","GU34 3","Total",2480,1231,1249,2480,0,100,7466.17,0.3
"2011","GU34 4","GU34 4","Total",3912,1919,1993,3689,223,158,5165.83,0.8
"2011","GU34 5","GU34 5","Total",6748,3321,3427,6669,79,191,4023.40,1.7
"2011","GU35 0","GU35 0","Total",11209,5647,5562,10881,328,155,1432.66,7.8
"2011","GU35 8","GU35 8","Total",5613,2734,2879,5570,43,126,1955.02,2.9
"2011","GU35 9","GU35 9","Total",6246,3131,3115,6236,10,108,2506.29,2.5
"2011","GU4  7","GU4  7","Total",10772,5190,5582,10737,35,275,2521.01,4.3
"2011","GU4  8","GU4  8","Total",5122,2400,2722,5096,26,146,1198.62,4.3
"2011","GU46 6","GU46 6","Total",11356,5558,5798,11354,2,219,599.14,19.0
"2011","GU46 7","GU46 7","Total",3473,1685,1788,3473,0,66,272.44,12.7
"2011","GU47 0","GU47 0","Total",10693,5279,5414,10671,22,176,512.71,20.9
"2011","GU47 8","GU47 8","Total",4389,2149,2240,4265,124,94,284.65,15.4
"2011","GU47 9","GU47 9","Total",3780,1863,1917,3743,37,47,177.39,21.3
"2011","GU5  0","GU5  0","Total",6971,3268,3703,6684,287,236,3605.43,1.9
"2011","GU5  9","GU5  9","Total",4249,2082,2167,4208,41,101,3235.69,1.3
"2011","GU51 1","GU51 1","Total",5183,2576,2607,5183,0,59,174.73,29.7
"2011","GU51 2","GU51 2","Total",2542,1305,1237,2542,0,53,521.54,4.9
"2011","GU51 3","GU51 3","Total",8538,4276,4262,8507,31,179,301.17,28.3
"2011","GU51 4","GU51 4","Total",4047,1889,2158,3858,189,124,275.30,14.7
"2011","GU51 5","GU51 5","Total",3294,1618,1676,3294,0,63,435.50,7.6
"2011","GU52 0","GU52 0","Total",2469,1222,1247,2469,0,35,52.17,47.3
"2011","GU52 6","GU52 6","Total",7574,3659,3915,7479,95,134,343.40,22.1
"2011","GU52 7","GU52 7","Total",3257,1637,1620,3257,0,88,101.35,32.1
"2011","GU52 8","GU52 8","Total",2653,1317,1336,2653,0,55,623.08,4.3
"2011","GU6  7","GU6  7","Total",8121,3934,4187,8056,65,169,1541.90,5.3
"2011","GU6  8","GU6  8","Total",6083,3000,3083,5531,552,171,4280.60,1.4
"2011","GU7  1","GU7  1","Total",7634,3746,3888,7438,196,251,659.82,11.6
"2011","GU7  2","GU7  2","Total",7064,3710,3354,6184,880,189,1044.62,6.8
"2011","GU7  3","GU7  3","Total",8126,3906,4220,8065,61,81,257.50,31.6
"2011","GU8  4","GU8  4","Total",5705,2822,2883,5521,184,242,6780.84,0.8
"2011","GU8  5","GU8  5","Total",8130,3903,4227,7826,304,195,2775.89,2.9
"2011","GU8  6","GU8  6","Total",3813,1903,1910,3737,76,112,4130.34,0.9
"2011","GU9  0","GU9  0","Total",7433,3663,3770,7433,0,124,457.47,16.2
"2011","GU9  7","GU9  7","Total",5155,2415,2740,4788,367,91,347.49,14.8
"2011","GU9  8","GU9  8","Total",9654,4711,4943,9555,99,228,547.41,17.6
"2011","GU9  9","GU9  9","Total",7442,3624,3818,7355,87,85,473.55,15.7
"2011","HA0  1","HA0  1","Total",9910,5140,4770,9909,1,83,168.51,58.8
"2011","HA0  2","HA0  2","Total",13298,6771,6527,13204,94,136,147.05,90.4
"2011","HA0  3","HA0  3","Total",11562,5995,5567,11526,36,167,213.58,54.1
"2011","HA0  4","HA0  4","Total",13588,7088,6500,13561,27,144,148.33,91.6
"2011","HA1  1","HA1  1","Total",7620,3910,3710,7532,88,85,84.80,89.9
"2011","HA1  2","HA1  2","Total",7338,3702,3636,7287,51,68,101.45,72.3
"2011","HA1  3","HA1  3","Total",10733,5643,5090,9244,1489,226,396.27,27.1
"2011","HA1  4","HA1  4","Total",13518,6746,6772,13468,50,219,208.27,64.9
"2011","HA2  0","HA2  0","Total",10856,5337,5519,10769,87,138,148.33,73.2
"2011","HA2  6","HA2  6","Total",8285,4050,4235,8279,6,195,234.18,35.4
"2011","HA2  7","HA2  7","Total",7665,3729,3936,7659,6,136,122.43,62.6
"2011","HA2  8","HA2  8","Total",13384,6672,6712,13375,9,188,172.71,77.5
"2011","HA2  9","HA2  9","Total",15078,7479,7599,15055,23,217,187.72,80.3
"2011","HA3  0","HA3  0","Total",11086,5467,5619,10854,232,211,216.89,51.1
"2011","HA3  5","HA3  5","Total",10451,5168,5283,10360,91,139,128.26,81.5
"2011","HA3  6","HA3  6","Total",8913,4326,4587,8846,67,179,441.85,20.2
"2011","HA3  7","HA3  7","Total",11941,5883,6058,11892,49,174,128.93,92.6
"2011","HA3  8","HA3  8","Total",11810,5832,5978,11722,88,242,186.12,63.5
"2011","HA3  9","HA3  9","Total",15353,7629,7724,15338,15,210,195.55,78.5
"2011","HA4  0","HA4  0","Total",9588,4625,4963,9554,34,132,193.96,49.4
"2011","HA4  6","HA4  6","Total",11109,5537,5572,10660,449,101,671.09,16.6
"2011","HA4  7","HA4  7","Total",10210,4946,5264,10108,102,186,519.58,19.7
"2011","HA4  8","HA4  8","Total",8371,4118,4253,8345,26,134,184.02,45.5
"2011","HA4  9","HA4  9","Total",10897,5256,5641,10847,50,147,183.11,59.5
"2011","HA5  1","HA5  1","Total",9342,4542,4800,9339,3,252,200.53,46.6
"2011","HA5  2","HA5  2","Total",8712,4198,4514,8651,61,177,285.98,30.5
"2011","HA5  3","HA5  3","Total",10423,4967,5456,10354,69,231,342.07,30.5
"2011","HA5  4","HA5  4","Total",8766,4184,4582,8666,100,257,287.94,30.4
"2011","HA5  5","HA5  5","Total",7742,3814,3928,7724,18,187,201.90,38.3
"2011","HA6  1","HA6  1","Total",8581,4074,4507,8551,30,145,249.08,34.5
"2011","HA6  2","HA6  2","Total",7908,3820,4088,7757,151,232,868.09,9.1
"2011","HA6  3","HA6  3","Total",5495,2652,2843,5205,290,216,254.32,21.6
"2011","HA7  1","HA7  1","Total",8127,3998,4129,8110,17,120,114.14,71.2
"2011","HA7  2","HA7  2","Total",12117,5992,6125,11995,122,222,196.64,61.6
"2011","HA7  3","HA7  3","Total",8357,4008,4349,8135,222,198,392.06,21.3
"2011","HA7  4","HA7  4","Total",8596,4001,4595,8593,3,184,720.80,11.9
"2011","HA8  0","HA8  0","Total",11717,5502,6215,11561,156,123,130.61,89.7
"2011","HA8  5","HA8  5","Total",12361,6204,6157,12306,55,148,133.32,92.7
"2011","HA8  6","HA8  6","Total",11406,5638,5768,11343,63,186,185.86,61.4
"2011","HA8  7","HA8  7","Total",4646,2312,2334,4646,0,106,105.73,43.9
"2011","HA8  8","HA8  8","Total",14624,7056,7568,14624,0,268,249.04,58.7
"2011","HA8  9","HA8  9","Total",11624,5662,5962,11521,103,209,166.56,69.8
"2011","HA9  0","HA9  0","Total",2646,1466,1180,2496,150,22,76.13,34.8
"2011","HA9  6","HA9  6","Total",10722,5558,5164,10630,92,91,182.37,58.8
"2011","HA9  7","HA9  7","Total",9081,4732,4349,9016,65,105,110.52,82.2
"2011","HA9  8","HA9  8","Total",13144,6597,6547,13016,128,150,210.22,62.5
"2011","HA9  9","HA9  9","Total",12252,6204,6048,12109,143,185,231.68,52.9
"2011","HD1  1","HD1  1","Total",241,161,80,239,2,4,21.73,11.1
"2011","HD1  3","HD1  3","Total",8307,4425,3882,7084,1223,60,131.20,63.3
"2011","HD1  4","HD1  4","Total",8542,4317,4225,8431,111,53,193.54,44.1
"2011","HD1  5","HD1  5","Total",2836,1569,1267,2783,53,18,78.15,36.3
"2011","HD1  6","HD1  6","Total",3036,1694,1342,3025,11,19,198.02,15.3
"2011","HD2  1","HD2  1","Total",15473,7394,8079,15320,153,112,726.61,21.3
"2011","HD2  2","HD2  2","Total",14030,7074,6956,13896,134,183,838.16,16.7
"2011","HD3  3","HD3  3","Total",15131,7307,7824,15026,105,244,775.46,19.5
"2011","HD3  4","HD3  4","Total",14158,6872,7286,14060,98,87,440.19,32.2
"2011","HD4  5","HD4  5","Total",12076,5912,6164,12039,37,84,292.87,41.2
"2011","HD4  6","HD4  6","Total",10940,5386,5554,10615,325,94,1904.89,5.7
"2011","HD4  7","HD4  7","Total",7259,3576,3683,7245,14,105,644.86,11.3
"2011","HD5  0","HD5  0","Total",5256,2533,2723,5218,38,49,702.35,7.5
"2011","HD5  8","HD5  8","Total",13800,6693,7107,13701,99,118,455.33,30.3
"2011","HD5  9","HD5  9","Total",12000,5893,6107,11964,36,72,441.34,27.2
"2011","HD6  1","HD6  1","Total",2645,1340,1305,2633,12,32,136.53,19.4
"2011","HD6  2","HD6  2","Total",7501,3645,3856,7477,24,94,462.54,16.2
"2011","HD6  3","HD6  3","Total",12066,5916,6150,11838,228,129,529.20,22.8
"2011","HD6  4","HD6  4","Total",5132,2535,2597,5129,3,70,892.09,5.8
"2011","HD7  4","HD7  4","Total",8294,4093,4201,8252,42,102,612.32,13.5
"2011","HD7  5","HD7  5","Total",9856,4925,4931,9813,43,98,1855.94,5.3
"2011","HD7  6","HD7  6","Total",4526,2194,2332,4525,1,43,3958.58,1.1
"2011","HD8  0","HD8  0","Total",11729,5812,5917,10524,1205,177,1880.09,6.2
"2011","HD8  8","HD8  8","Total",12040,5947,6093,12018,22,233,3376.62,3.6
"2011","HD8  9","HD8  9","Total",10551,5168,5383,10461,90,150,2102.81,5.0
"2011","HD9  1","HD9  1","Total",7248,3580,3668,7240,8,141,1245.20,5.8
"2011","HD9  2","HD9  2","Total",4275,2126,2149,4275,0,62,3203.68,1.3
"2011","HD9  3","HD9  3","Total",4000,1986,2014,3910,90,83,846.11,4.7
"2011","HD9  4","HD9  4","Total",3984,1917,2067,3905,79,49,1047.83,3.8
"2011","HD9  5","HD9  5","Total",4550,2218,2332,4514,36,52,1302.37,3.5
"2011","HD9  6","HD9  6","Total",6351,3108,3243,6334,17,91,792.84,8.0
"2011","HD9  7","HD9  7","Total",4981,2457,2524,4979,2,111,565.39,8.8
"2011","HG1  1","HG1  1","Total",1176,634,542,1176,0,17,34.67,33.9
"2011","HG1  2","HG1  2","Total",7614,3576,4038,7125,489,130,379.25,20.1
"2011","HG1  3","HG1  3","Total",7454,3635,3819,7454,0,122,514.63,14.5
"2011","HG1  4","HG1  4","Total",12176,5931,6245,11944,232,126,338.18,36.0
"2011","HG1  5","HG1  5","Total",5781,2979,2802,5707,74,79,88.23,65.5
"2011","HG2  0","HG2  0","Total",7976,3731,4245,7731,245,145,245.87,32.4
"2011","HG2  7","HG2  7","Total",11125,5209,5916,10899,226,109,351.14,31.7
"2011","HG2  8","HG2  8","Total",8667,4175,4492,8470,197,232,591.69,14.6
"2011","HG2  9","HG2  9","Total",5705,2738,2967,5540,165,173,262.81,21.7
"2011","HG3  1","HG3  1","Total",5251,2561,2690,5181,70,169,8765.78,0.6
"2011","HG3  2","HG3  2","Total",11149,5447,5702,10967,182,145,4695.29,2.4
"2011","HG3  3","HG3  3","Total",4389,2178,2211,4350,39,110,8569.95,0.5
"2011","HG3  4","HG3  4","Total",2176,1071,1105,2172,4,54,8809.48,0.2
"2011","HG3  5","HG3  5","Total",3435,1679,1756,3410,25,49,17642.39,0.2
"2011","HG4  1","HG4  1","Total",8099,4018,4081,7961,138,84,456.10,17.8
"2011","HG4  2","HG4  2","Total",8603,4363,4240,7987,616,109,537.73,16.0
"2011","HG4  3","HG4  3","Total",4180,2062,2118,4142,38,115,14890.49,0.3
"2011","HG4  4","HG4  4","Total",2419,1180,1239,2406,13,47,12982.82,0.2
"2011","HG4  5","HG4  5","Total",2551,1222,1329,2516,35,51,5989.40,0.4
"2011","HG5  0","HG5  0","Total",8994,4410,4584,8975,19,122,4012.19,2.2
"2011","HG5  8","HG5  8","Total",5127,2483,2644,5038,89,130,1868.26,2.7
"2011","HG5  9","HG5  9","Total",4296,2071,2225,4247,49,129,2126.97,2.0
"2011","HP1  1","HP1  1","Total",7722,3819,3903,7699,23,134,214.64,36.0
"2011","HP1  2","HP1  2","Total",8622,4231,4391,8620,2,154,485.49,17.8
"2011","HP1  3","HP1  3","Total",8069,3933,4136,7952,117,128,1044.18,7.7
"2011","HP10 0","HP10 0","Total",5261,2507,2754,5230,31,74,515.38,10.2
"2011","HP10 8","HP10 8","Total",5683,2770,2913,5658,25,195,695.62,8.2
"2011","HP10 9","HP10 9","Total",8021,3905,4116,8015,6,166,745.08,10.8
"2011","HP11 1","HP11 1","Total",7739,3605,4134,6997,742,152,540.62,14.3
"2011","HP11 2","HP11 2","Total",5766,2967,2799,5368,398,76,141.11,40.9
"2011","HP12 3","HP12 3","Total",12382,6365,6017,12359,23,146,232.22,53.3
"2011","HP12 4","HP12 4","Total",10440,5145,5295,10314,126,138,819.93,12.7
"2011","HP13 5","HP13 5","Total",13988,7005,6983,13596,392,235,697.42,20.1
"2011","HP13 6","HP13 6","Total",11272,5719,5553,11106,166,180,219.84,51.3
"2011","HP13 7","HP13 7","Total",17799,8782,9017,17796,3,156,431.10,41.3
"2011","HP14 3","HP14 3","Total",9439,4673,4766,9407,32,189,4394.71,2.1
"2011","HP14 4","HP14 4","Total",8284,4168,4116,8003,281,268,3636.70,2.3
"2011","HP15 6","HP15 6","Total",8171,3960,4211,8141,30,195,1253.64,6.5
"2011","HP15 7","HP15 7","Total",9257,4477,4780,9183,74,190,398.75,23.2
"2011","HP16 0","HP16 0","Total",6965,3367,3598,6891,74,223,1658.63,4.2
"2011","HP16 9","HP16 9","Total",4881,2371,2510,4866,15,173,3168.97,1.5
"2011","HP17 0","HP17 0","Total",1148,563,585,1148,0,30,1758.35,0.7
"2011","HP17 8","HP17 8","Total",7994,3854,4140,7895,99,194,4359.29,1.8
"2011","HP17 9","HP17 9","Total",902,458,444,902,0,19,1306.66,0.7
"2011","HP18 0","HP18 0","Total",6218,3280,2938,5701,517,159,8844.23,0.7
"2011","HP18 9","HP18 9","Total",7304,3610,3694,7268,36,193,9146.25,0.8
"2011","HP19 0","HP19 0","Total",2343,1157,1186,2296,47,29,127.12,18.4
"2011","HP19 7","HP19 7","Total",6998,3491,3507,6998,0,50,131.27,53.3
"2011","HP19 8","HP19 8","Total",3522,1768,1754,3400,122,30,965.41,3.6
"2011","HP19 9","HP19 9","Total",10894,5333,5561,10824,70,109,617.04,17.7
"2011","HP2  4","HP2  4","Total",11035,5343,5692,10777,258,108,434.09,25.4
"2011","HP2  5","HP2  5","Total",12549,6065,6484,12297,252,115,235.80,53.2
"2011","HP2  6","HP2  6","Total",7832,3932,3900,7816,16,88,1760.66,4.4
"2011","HP2  7","HP2  7","Total",7016,3490,3526,7016,0,96,232.18,30.2
"2011","HP20 1","HP20 1","Total",8042,4130,3912,7648,394,78,198.33,40.5
"2011","HP20 2","HP20 2","Total",6866,3437,3429,6855,11,59,130.13,52.8
"2011","HP21 7","HP21 7","Total",9634,4835,4799,9543,91,170,239.30,40.3
"2011","HP21 8","HP21 8","Total",13165,6488,6677,13092,73,126,243.93,54.0
"2011","HP21 9","HP21 9","Total",10556,5184,5372,10496,60,138,248.45,42.5
"2011","HP22 4","HP22 4","Total",5170,2523,2647,5120,50,140,6760.60,0.8
"2011","HP22 5","HP22 5","Total",13431,6526,6905,13064,367,325,5009.75,2.7
"2011","HP22 6","HP22 6","Total",6097,2896,3201,5959,138,110,1776.92,3.4
"2011","HP23 4","HP23 4","Total",6051,2929,3122,6003,48,157,2955.33,2.0
"2011","HP23 5","HP23 5","Total",8076,3943,4133,7888,188,199,1614.15,5.0
"2011","HP23 6","HP23 6","Total",3332,1589,1743,3324,8,105,1998.26,1.7
"2011","HP27 0","HP27 0","Total",6429,3041,3388,6293,136,143,1541.50,4.2
"2011","HP27 9","HP27 9","Total",5782,2842,2940,5720,62,129,2767.55,2.1
"2011","HP3  0","HP3  0","Total",8126,4340,3786,7345,781,159,2578.80,3.2
"2011","HP3  8","HP3  8","Total",9849,4822,5027,9849,0,131,679.05,14.5
"2011","HP3  9","HP3  9","Total",14119,7045,7074,14060,59,154,329.56,42.8
"2011","HP4  1","HP4  1","Total",6982,3441,3541,6950,32,169,3552.51,2.0
"2011","HP4  2","HP4  2","Total",7520,3680,3840,7418,102,183,1233.72,6.1
"2011","HP4  3","HP4  3","Total",9471,4540,4931,9427,44,246,430.43,22.0
"2011","HP5  1","HP5  1","Total",6680,3216,3464,6604,76,100,1481.80,4.5
"2011","HP5  2","HP5  2","Total",11433,5731,5702,11423,10,211,2332.85,4.9
"2011","HP5  3","HP5  3","Total",7277,3628,3649,7239,38,160,1430.78,5.1
"2011","HP6  5","HP6  5","Total",5849,2868,2981,5797,52,199,660.55,8.9
"2011","HP6  6","HP6  6","Total",8301,3947,4354,8188,113,221,340.69,24.4
"2011","HP7  0","HP7  0","Total",4216,2078,2138,4174,42,104,2970.80,1.4
"2011","HP7  9","HP7  9","Total",6409,3101,3308,6396,13,134,879.91,7.3
"2011","HP8  4","HP8  4","Total",6819,3306,3513,6819,0,232,1431.88,4.8
"2011","HP9  1","HP9  1","Total",9026,4342,4684,8905,121,288,778.97,11.6
"2011","HP9  2","HP9  2","Total",8127,3976,4151,7953,174,307,2016.62,4.0
"2011","HR1  1","HR1  1","Total",14112,6836,7276,13712,400,255,605.34,23.3
"2011","HR1  2","HR1  2","Total",5249,2612,2637,5117,132,85,203.32,25.8
"2011","HR1  3","HR1  3","Total",6371,3159,3212,6144,227,130,8977.90,0.7
"2011","HR1  4","HR1  4","Total",6153,3051,3102,5972,181,146,10023.31,0.6
"2011","HR2  0","HR2  0","Total",4364,2177,2187,4338,26,98,20293.02,0.2
"2011","HR2  6","HR2  6","Total",8408,4185,4223,8344,64,81,3458.96,2.4
"2011","HR2  7","HR2  7","Total",15425,7576,7849,15410,15,119,530.74,29.1
"2011","HR2  8","HR2  8","Total",4998,2492,2506,4895,103,112,13372.68,0.4
"2011","HR2  9","HR2  9","Total",5926,2933,2993,5896,30,117,9976.18,0.6
"2011","HR3  5","HR3  5","Total",4762,2342,2420,4712,50,77,15953.14,0.3
"2011","HR3  6","HR3  6","Total",2994,1478,1516,2992,2,70,11689.39,0.3
"2011","HR4  0","HR4  0","Total",10864,5394,5470,10789,75,146,540.98,20.1
"2011","HR4  7","HR4  7","Total",5711,2862,2849,5539,172,120,8872.69,0.6
"2011","HR4  8","HR4  8","Total",6030,2955,3075,6021,9,105,10956.31,0.6
"2011","HR4  9","HR4  9","Total",7734,3894,3840,7697,37,62,429.86,18.0
"2011","HR5  3","HR5  3","Total",4670,2255,2415,4517,153,74,12795.95,0.4
"2011","HR6  0","HR6  0","Total",4440,2188,2252,4424,16,106,15065.95,0.3
"2011","HR6  8","HR6  8","Total",10674,5184,5490,10553,121,71,929.22,11.5
"2011","HR6  9","HR6  9","Total",5379,2668,2711,5274,105,112,14316.89,0.4
"2011","HR7  4","HR7  4","Total",7155,3534,3621,6934,221,110,13254.58,0.5
"2011","HR8  1","HR8  1","Total",4367,2148,2219,4295,72,91,6879.95,0.6
"2011","HR8  2","HR8  2","Total",9648,4701,4947,9533,115,158,9205.56,1.0
"2011","HR9  5","HR9  5","Total",7240,3506,3734,7071,169,120,3126.90,2.3
"2011","HR9  6","HR9  6","Total",4561,2225,2336,4427,134,90,7059.73,0.6
"2011","HR9  7","HR9  7","Total",9258,4537,4721,9157,101,159,7337.24,1.3
"2011","HU1  1","HU1  1","Total",902,539,363,807,95,28,34.82,25.9
"2011","HU1  2","HU1  2","Total",2188,1341,847,2070,118,8,108.43,20.2
"2011","HU1  3","HU1  3","Total",204,117,87,204,0,0,11.26,18.1
"2011","HU10 6","HU10 6","Total",10910,5236,5674,10825,85,121,633.52,17.2
"2011","HU10 7","HU10 7","Total",8147,3981,4166,8030,117,132,812.91,10.0
"2011","HU11 4","HU11 4","Total",8099,4003,4096,8066,33,76,10587.88,0.8
"2011","HU11 5","HU11 5","Total",3759,1836,1923,3759,0,52,5376.98,0.7
"2011","HU12 0","HU12 0","Total",5444,2724,2720,5305,139,41,14255.14,0.4
"2011","HU12 8","HU12 8","Total",11081,5339,5742,10918,163,124,4152.31,2.7
"2011","HU12 9","HU12 9","Total",9071,4539,4532,9035,36,101,7808.41,1.2
"2011","HU13 0","HU13 0","Total",7464,3570,3894,7156,308,132,414.96,18.0
"2011","HU13 9","HU13 9","Total",7536,3652,3884,7507,29,72,157.08,48.0
"2011","HU14 3","HU14 3","Total",8278,4073,4205,8206,72,190,2452.28,3.4
"2011","HU15 1","HU15 1","Total",13163,6793,6370,12397,766,194,3343.16,3.9
"2011","HU15 2","HU15 2","Total",10984,5361,5623,10898,86,181,6206.85,1.8
"2011","HU16 4","HU16 4","Total",6799,3192,3607,6591,208,111,568.95,12.0
"2011","HU16 5","HU16 5","Total",9667,4705,4962,8401,1266,170,2434.23,4.0
"2011","HU17 0","HU17 0","Total",10226,4982,5244,10169,57,92,1740.04,5.9
"2011","HU17 5","HU17 5","Total",2673,1316,1357,2665,8,34,2257.60,1.2
"2011","HU17 7","HU17 7","Total",8731,4275,4456,8549,182,243,6863.06,1.3
"2011","HU17 8","HU17 8","Total",11492,5464,6028,11099,393,268,3742.55,3.1
"2011","HU17 9","HU17 9","Total",10377,5024,5353,10238,139,136,2617.89,4.0
"2011","HU18 1","HU18 1","Total",8774,4234,4540,8564,210,108,2483.57,3.5
"2011","HU19 2","HU19 2","Total",7135,3558,3577,6953,182,44,3428.71,2.1
"2011","HU2  0","HU2  0","Total",1074,565,509,1074,0,3,40.21,26.7
"2011","HU2  8","HU2  8","Total",1633,981,652,1558,75,3,61.57,26.5
"2011","HU2  9","HU2  9","Total",1310,668,642,1309,1,2,26.48,49.5
"2011","HU20 3","HU20 3","Total",1015,478,537,986,29,27,2599.86,0.4
"2011","HU3  1","HU3  1","Total",6530,3676,2854,6448,82,34,161.36,40.5
"2011","HU3  2","HU3  2","Total",5497,3046,2451,5307,190,33,85.98,63.9
"2011","HU3  3","HU3  3","Total",4429,2210,2219,4307,122,17,234.52,18.9
"2011","HU3  5","HU3  5","Total",2629,1281,1348,2581,48,8,65.16,40.3
"2011","HU3  6","HU3  6","Total",8250,4212,4038,8178,72,57,154.76,53.3
"2011","HU4  6","HU4  6","Total",12587,6125,6462,12448,139,77,356.01,35.4
"2011","HU4  7","HU4  7","Total",10621,5143,5478,10554,67,67,296.73,35.8
"2011","HU5  1","HU5  1","Total",5651,3059,2592,5540,111,42,138.24,40.9
"2011","HU5  2","HU5  2","Total",9275,4825,4450,9110,165,107,129.58,71.6
"2011","HU5  3","HU5  3","Total",10009,5182,4827,9960,49,107,134.40,74.5
"2011","HU5  4","HU5  4","Total",8945,4360,4585,8941,4,82,278.39,32.1
"2011","HU5  5","HU5  5","Total",17184,8346,8838,17184,0,79,314.18,54.7
"2011","HU6  0","HU6  0","Total",485,247,238,485,0,4,266.12,1.8
"2011","HU6  7","HU6  7","Total",11980,6095,5885,11485,495,137,358.78,33.4
"2011","HU6  8","HU6  8","Total",9568,4662,4906,9568,0,42,170.58,56.1
"2011","HU6  9","HU6  9","Total",11942,5756,6186,11942,0,53,212.05,56.3
"2011","HU7  0","HU7  0","Total",1873,985,888,1873,0,3,186.21,10.1
"2011","HU7  3","HU7  3","Total",6762,3362,3400,6713,49,52,322.40,21.0
"2011","HU7  4","HU7  4","Total",23720,11630,12090,23434,286,96,766.95,30.9
"2011","HU7  5","HU7  5","Total",5059,2396,2663,5030,29,18,1843.78,2.7
"2011","HU7  6","HU7  6","Total",4868,2337,2531,4868,0,17,116.29,41.9
"2011","HU8  0","HU8  0","Total",9405,4581,4824,9345,60,66,225.48,41.7
"2011","HU8  7","HU8  7","Total",2100,1073,1027,2100,0,8,141.17,14.9
"2011","HU8  8","HU8  8","Total",8681,4342,4339,8615,66,41,156.13,55.6
"2011","HU8  9","HU8  9","Total",14629,7089,7540,14480,149,82,403.51,36.3
"2011","HU9  1","HU9  1","Total",4521,2450,2071,4469,52,12,153.54,29.4
"2011","HU9  2","HU9  2","Total",5837,2952,2885,5707,130,26,73.19,79.8
"2011","HU9  3","HU9  3","Total",10398,4996,5402,10241,157,54,194.04,53.6
"2011","HU9  4","HU9  4","Total",12950,6158,6792,12839,111,48,274.04,47.3
"2011","HU9  5","HU9  5","Total",8702,4548,4154,7960,742,21,790.70,11.0
"2011","HX1  1","HX1  1","Total",484,259,225,483,1,1,33.66,14.4
"2011","HX1  2","HX1  2","Total",4283,2213,2070,4178,105,52,154.20,27.8
"2011","HX1  3","HX1  3","Total",7453,3744,3709,7435,18,52,85.64,87.0
"2011","HX1  4","HX1  4","Total",7457,3694,3763,7448,9,21,96.42,77.3
"2011","HX1  5","HX1  5","Total",4454,2267,2187,4361,93,26,86.69,51.4
"2011","HX2  0","HX2  0","Total",8779,4210,4569,8747,32,60,515.99,17.0
"2011","HX2  6","HX2  6","Total",5025,2459,2566,5010,15,62,1647.09,3.1
"2011","HX2  7","HX2  7","Total",6087,2954,3133,6087,0,68,792.30,7.7
"2011","HX2  8","HX2  8","Total",7032,3411,3621,7027,5,37,577.28,12.2
"2011","HX2  9","HX2  9","Total",8953,4329,4624,8890,63,59,1027.03,8.7
"2011","HX3  0","HX3  0","Total",7592,3616,3976,7468,124,125,279.36,27.2
"2011","HX3  5","HX3  5","Total",8079,3932,4147,8008,71,54,187.97,43.0
"2011","HX3  6","HX3  6","Total",6403,3233,3170,6365,38,50,626.62,10.2
"2011","HX3  7","HX3  7","Total",9651,4669,4982,9640,11,136,884.25,10.9
"2011","HX3  8","HX3  8","Total",7215,3506,3709,7115,100,129,717.35,10.1
"2011","HX3  9","HX3  9","Total",7003,3459,3544,6983,20,41,678.25,10.3
"2011","HX4  0","HX4  0","Total",1699,836,863,1699,0,28,851.32,2.0
"2011","HX4  8","HX4  8","Total",6305,3092,3213,6253,52,77,710.13,8.9
"2011","HX4  9","HX4  9","Total",4172,2006,2166,4172,0,53,822.76,5.1
"2011","HX5  0","HX5  0","Total",5830,2770,3060,5770,60,49,255.23,22.8
"2011","HX5  9","HX5  9","Total",4431,2178,2253,4422,9,27,555.05,8.0
"2011","HX6  1","HX6  1","Total",4262,2030,2232,4241,21,44,777.52,5.5
"2011","HX6  2","HX6  2","Total",6179,3099,3080,6143,36,48,163.58,37.8
"2011","HX6  3","HX6  3","Total",3073,1525,1548,3073,0,46,775.04,4.0
"2011","HX6  4","HX6  4","Total",5174,2533,2641,5091,83,104,4572.35,1.1
"2011","HX7  5","HX7  5","Total",4661,2220,2441,4659,2,47,2268.05,2.1
"2011","HX7  6","HX7  6","Total",2257,1077,1180,2250,7,22,690.38,3.3
"2011","HX7  7","HX7  7","Total",2609,1269,1340,2607,2,52,3441.98,0.8
"2011","HX7  8","HX7  8","Total",3776,1818,1958,3776,0,66,4886.18,0.8
"2011","IG1  1","IG1  1","Total",14177,7311,6866,14128,49,131,131.81,107.6
"2011","IG1  2","IG1  2","Total",20275,10162,10113,20068,207,153,152.22,133.2
"2011","IG1  3","IG1  3","Total",17204,8981,8223,17071,133,188,238.85,72.0
"2011","IG1  4","IG1  4","Total",12894,6400,6494,12858,36,171,174.38,73.9
"2011","IG10 1","IG10 1","Total",6794,3319,3475,6735,59,142,464.76,14.6
"2011","IG10 2","IG10 2","Total",9211,4458,4753,9211,0,90,372.66,24.7
"2011","IG10 3","IG10 3","Total",10748,5108,5640,10725,23,99,412.58,26.1
"2011","IG10 4","IG10 4","Total",4774,2328,2446,4749,25,107,887.18,5.4
"2011","IG11 0","IG11 0","Total",9655,4727,4928,9655,0,77,629.17,15.3
"2011","IG11 7","IG11 7","Total",15960,8101,7859,15862,98,139,133.78,119.3
"2011","IG11 8","IG11 8","Total",8157,4358,3799,8145,12,60,93.11,87.6
"2011","IG11 9","IG11 9","Total",19587,9696,9891,19555,32,207,264.97,73.9
"2011","IG2  6","IG2  6","Total",14376,7202,7174,14157,219,241,160.91,89.3
"2011","IG2  7","IG2  7","Total",14592,7177,7415,14509,83,222,197.89,73.7
"2011","IG3  8","IG3  8","Total",17418,8906,8512,17188,230,213,242.60,71.8
"2011","IG3  9","IG3  9","Total",18650,9440,9210,18604,46,220,274.69,67.9
"2011","IG4  5","IG4  5","Total",8912,4438,4474,8912,0,176,161.90,55.0
"2011","IG5  0","IG5  0","Total",17014,8316,8698,16972,42,340,284.35,59.8
"2011","IG6  1","IG6  1","Total",8274,4011,4263,8274,0,123,194.32,42.6
"2011","IG6  2","IG6  2","Total",11800,5717,6083,11795,5,156,236.88,49.8
"2011","IG6  3","IG6  3","Total",6695,3175,3520,6645,50,47,545.90,12.3
"2011","IG7  4","IG7  4","Total",7365,3459,3906,7365,0,60,121.74,60.5
"2011","IG7  5","IG7  5","Total",8533,4084,4449,8411,122,155,311.52,27.4
"2011","IG7  6","IG7  6","Total",4499,2227,2272,4467,32,87,1234.32,3.6
"2011","IG8  0","IG8  0","Total",8432,4118,4314,8298,134,213,261.67,32.2
"2011","IG8  7","IG8  7","Total",9373,4593,4780,9373,0,118,134.11,69.9
"2011","IG8  8","IG8  8","Total",8145,3953,4192,8138,7,95,272.92,29.8
"2011","IG8  9","IG8  9","Total",9295,4489,4806,9261,34,191,229.75,40.5
"2011","IG9  5","IG9  5","Total",7564,3624,3940,7447,117,147,294.15,25.7
"2011","IG9  6","IG9  6","Total",5321,2538,2783,5251,70,77,148.84,35.7
"2011","IP1  1","IP1  1","Total",549,323,226,530,19,2,31.19,17.6
"2011","IP1  2","IP1  2","Total",5519,3135,2384,5061,458,25,95.96,57.5
"2011","IP1  3","IP1  3","Total",3396,1703,1693,3092,304,65,85.30,39.8
"2011","IP1  4","IP1  4","Total",8626,4281,4345,8571,55,117,227.32,37.9
"2011","IP1  5","IP1  5","Total",9214,4582,4632,9214,0,49,267.09,34.5
"2011","IP1  6","IP1  6","Total",12239,5954,6285,12180,59,92,998.23,12.3
"2011","IP10 0","IP10 0","Total",3058,1530,1528,3005,53,68,4553.44,0.7
"2011","IP11 0","IP11 0","Total",5306,2638,2668,5296,10,66,1578.75,3.4
"2011","IP11 2","IP11 2","Total",8816,4328,4488,8700,116,67,564.49,15.6
"2011","IP11 7","IP11 7","Total",6505,3036,3469,6181,324,125,179.63,36.2
"2011","IP11 9","IP11 9","Total",8669,4133,4536,8648,21,115,934.07,9.3
"2011","IP12 1","IP12 1","Total",6707,3166,3541,6646,61,123,648.44,10.3
"2011","IP12 2","IP12 2","Total",5519,2669,2850,5470,49,89,9506.59,0.6
"2011","IP12 3","IP12 3","Total",4811,2814,1997,3973,838,73,10717.99,0.4
"2011","IP12 4","IP12 4","Total",7360,3489,3871,7225,135,166,2161.47,3.4
"2011","IP13 0","IP13 0","Total",3992,1905,2087,3921,71,59,4944.86,0.8
"2011","IP13 6","IP13 6","Total",4679,2322,2357,4674,5,134,5169.19,0.9
"2011","IP13 7","IP13 7","Total",3095,1543,1552,3069,26,95,6684.26,0.5
"2011","IP13 8","IP13 8","Total",2264,1124,1140,2258,6,54,5651.60,0.4
"2011","IP13 9","IP13 9","Total",4102,1969,2133,3804,298,94,3757.74,1.1
"2011","IP14 1","IP14 1","Total",9204,4467,4737,9065,139,104,330.57,27.8
"2011","IP14 2","IP14 2","Total",6620,3244,3376,6587,33,100,2578.21,2.6
"2011","IP14 3","IP14 3","Total",4545,2201,2344,4381,164,84,4453.54,1.0
"2011","IP14 4","IP14 4","Total",5797,2910,2887,5767,30,103,5245.19,1.1
"2011","IP14 5","IP14 5","Total",8661,4301,4360,8656,5,114,5948.60,1.5
"2011","IP14 6","IP14 6","Total",4176,2016,2160,4173,3,106,6911.54,0.6
"2011","IP15 5","IP15 5","Total",2466,1115,1351,2424,42,32,968.83,2.5
"2011","IP16 4","IP16 4","Total",6546,3166,3380,6417,129,75,3647.33,1.8
"2011","IP17 1","IP17 1","Total",6407,3051,3356,6330,77,94,5125.54,1.3
"2011","IP17 2","IP17 2","Total",2476,1237,1239,2476,0,48,5855.02,0.4
"2011","IP17 3","IP17 3","Total",1901,911,990,1843,58,35,5472.99,0.3
"2011","IP18 6","IP18 6","Total",4060,1840,2220,3946,114,62,2210.57,1.8
"2011","IP19 0","IP19 0","Total",2364,1184,1180,2361,3,51,9381.13,0.3
"2011","IP19 8","IP19 8","Total",5900,2805,3095,5826,74,64,1900.71,3.1
"2011","IP19 9","IP19 9","Total",2017,1017,1000,1974,43,45,5653.02,0.4
"2011","IP2  0","IP2  0","Total",9578,4692,4886,9474,104,51,438.07,21.9
"2011","IP2  8","IP2  8","Total",7457,3757,3700,7195,262,52,1087.60,6.9
"2011","IP2  9","IP2  9","Total",14098,6980,7118,14055,43,118,340.22,41.4
"2011","IP20 0","IP20 0","Total",2511,1234,1277,2511,0,27,5411.72,0.5
"2011","IP20 9","IP20 9","Total",5281,2557,2724,5251,30,41,2743.90,1.9
"2011","IP21 4","IP21 4","Total",6384,3210,3174,6333,51,81,8706.33,0.7
"2011","IP21 5","IP21 5","Total",4836,2389,2447,4809,27,79,9040.47,0.5
"2011","IP22 1","IP22 1","Total",5374,2609,2765,5329,45,94,7297.79,0.7
"2011","IP22 2","IP22 2","Total",5438,2717,2721,5419,19,85,11074.03,0.5
"2011","IP22 4","IP22 4","Total",8278,3990,4288,8209,69,57,574.82,14.4
"2011","IP22 5","IP22 5","Total",2786,1375,1411,2734,52,43,3162.61,0.9
"2011","IP23 7","IP23 7","Total",4332,2097,2235,4311,21,80,6612.63,0.7
"2011","IP23 8","IP23 8","Total",2678,1334,1344,2615,63,50,3528.52,0.8
"2011","IP24 1","IP24 1","Total",9879,4882,4997,9856,23,81,8283.23,1.2
"2011","IP24 2","IP24 2","Total",9897,4951,4946,9752,145,81,8686.27,1.1
"2011","IP24 3","IP24 3","Total",8049,3978,4071,8024,25,54,4056.75,2.0
"2011","IP25 6","IP25 6","Total",11625,6144,5481,10583,1042,84,5960.84,2.0
"2011","IP25 7","IP25 7","Total",6588,3171,3417,6534,54,81,9532.17,0.7
"2011","IP26 4","IP26 4","Total",5522,2720,2802,5501,21,50,13232.64,0.4
"2011","IP26 5","IP26 5","Total",3423,1718,1705,3343,80,41,13735.21,0.2
"2011","IP27 0","IP27 0","Total",11221,5601,5620,11157,64,67,7847.92,1.4
"2011","IP27 9","IP27 9","Total",7792,4140,3652,6730,1062,42,7616.27,1.0
"2011","IP28 6","IP28 6","Total",5584,2769,2815,5290,294,98,14130.01,0.4
"2011","IP28 7","IP28 7","Total",9101,4535,4566,9031,70,79,1224.63,7.4
"2011","IP28 8","IP28 8","Total",9813,4995,4818,9662,151,65,5334.67,1.8
"2011","IP29 4","IP29 4","Total",4415,2177,2238,4390,25,112,8737.64,0.5
"2011","IP29 5","IP29 5","Total",4602,2253,2349,4557,45,90,7185.07,0.6
"2011","IP3  0","IP3  0","Total",10491,5236,5255,10022,469,76,399.89,26.2
"2011","IP3  8","IP3  8","Total",11900,5901,5999,11844,56,154,590.80,20.1
"2011","IP3  9","IP3  9","Total",12182,5962,6220,12145,37,78,462.66,26.3
"2011","IP30 0","IP30 0","Total",4232,2112,2120,4232,0,77,6958.93,0.6
"2011","IP30 9","IP30 9","Total",9342,4590,4752,9338,4,178,5837.06,1.6
"2011","IP31 1","IP31 1","Total",6293,3441,2852,5506,787,104,7229.26,0.9
"2011","IP31 2","IP31 2","Total",7985,3946,4039,7860,125,134,5974.94,1.3
"2011","IP31 3","IP31 3","Total",7021,3443,3578,7002,19,174,5762.69,1.2
"2011","IP32 6","IP32 6","Total",8793,4326,4467,8756,37,67,243.45,36.1
"2011","IP32 7","IP32 7","Total",8298,4155,4143,8289,9,122,453.78,18.3
"2011","IP33 1","IP33 1","Total",4438,2167,2271,4271,167,76,148.15,30.0
"2011","IP33 2","IP33 2","Total",9430,4598,4832,9334,96,154,535.19,17.6
"2011","IP33 3","IP33 3","Total",10337,5048,5289,10214,123,159,712.25,14.5
"2011","IP4  1","IP4  1","Total",3394,1749,1645,3325,69,34,65.94,51.5
"2011","IP4  2","IP4  2","Total",7850,3933,3917,7774,76,159,196.71,39.9
"2011","IP4  3","IP4  3","Total",5146,2472,2674,5089,57,83,325.17,15.8
"2011","IP4  4","IP4  4","Total",7818,3872,3946,7760,58,98,145.32,53.8
"2011","IP4  5","IP4  5","Total",12158,5961,6197,12012,146,184,333.20,36.5
"2011","IP5  1","IP5  1","Total",5548,2706,2842,5543,5,69,528.89,10.5
"2011","IP5  2","IP5  2","Total",10432,5100,5332,10329,103,176,364.78,28.6
"2011","IP5  3","IP5  3","Total",3669,1815,1854,3669,0,87,363.95,10.1
"2011","IP6  0","IP6  0","Total",5509,2735,2774,5460,49,61,1978.95,2.8
"2011","IP6  8","IP6  8","Total",6212,2999,3213,6137,75,91,4053.64,1.5
"2011","IP6  9","IP6  9","Total",4458,2231,2227,4425,33,106,6992.23,0.6
"2011","IP7  5","IP7  5","Total",6440,3100,3340,6404,36,128,2691.28,2.4
"2011","IP7  6","IP7  6","Total",4904,2432,2472,4858,46,89,4977.94,1.0
"2011","IP7  7","IP7  7","Total",5277,2998,2279,4434,843,115,6800.35,0.8
"2011","IP8  3","IP8  3","Total",6752,3318,3434,6700,52,103,3837.91,1.8
"2011","IP8  4","IP8  4","Total",4168,2073,2095,4168,0,56,3641.31,1.1
"2011","IP9  1","IP9  1","Total",4194,2065,2129,4160,34,62,3428.04,1.2
"2011","IP9  2","IP9  2","Total",7155,3512,3643,6602,553,193,4218.34,1.7
"2011","KT1  1","KT1  1","Total",1007,528,479,819,188,6,22.73,44.3
"2011","KT1  2","KT1  2","Total",8197,4033,4164,7947,250,132,120.21,68.2
"2011","KT1  3","KT1  3","Total",11618,5689,5929,11577,41,164,174.56,66.6
"2011","KT1  4","KT1  4","Total",3076,1521,1555,2861,215,38,126.23,24.4
"2011","KT10 0","KT10 0","Total",9577,4629,4948,9480,97,272,653.49,14.7
"2011","KT10 8","KT10 8","Total",6312,3059,3253,6299,13,167,493.81,12.8
"2011","KT10 9","KT10 9","Total",5004,2480,2524,4966,38,221,642.89,7.8
"2011","KT11 1","KT11 1","Total",3111,1467,1644,3014,97,54,370.80,8.4
"2011","KT11 2","KT11 2","Total",9194,4492,4702,8957,237,368,1008.11,9.1
"2011","KT11 3","KT11 3","Total",2675,1309,1366,2624,51,85,1228.96,2.2
"2011","KT12 1","KT12 1","Total",4305,2102,2203,4284,21,97,158.78,27.1
"2011","KT12 2","KT12 2","Total",11771,5717,6054,11771,0,154,467.57,25.2
"2011","KT12 3","KT12 3","Total",8061,3883,4178,7956,105,144,338.58,23.8
"2011","KT12 4","KT12 4","Total",5614,2670,2944,5502,112,48,709.00,7.9
"2011","KT12 5","KT12 5","Total",7083,3418,3665,7049,34,166,340.04,20.8
"2011","KT13 0","KT13 0","Total",6581,3185,3396,6459,122,195,676.83,9.7
"2011","KT13 8","KT13 8","Total",7147,3502,3645,7099,48,106,440.21,16.2
"2011","KT13 9","KT13 9","Total",7564,3706,3858,7485,79,153,221.44,34.2
"2011","KT14 6","KT14 6","Total",5626,2707,2919,5586,40,174,351.11,16.0
"2011","KT14 7","KT14 7","Total",7724,3737,3987,7662,62,68,285.31,27.1
"2011","KT15 1","KT15 1","Total",9820,4727,5093,9633,187,136,433.37,22.7
"2011","KT15 2","KT15 2","Total",8257,4048,4209,8253,4,74,400.46,20.6
"2011","KT15 3","KT15 3","Total",9296,4593,4703,9232,64,150,531.60,17.5
"2011","KT16 0","KT16 0","Total",5672,2754,2918,5558,114,91,1834.57,3.1
"2011","KT16 8","KT16 8","Total",5991,2948,3043,5930,61,46,448.93,13.3
"2011","KT16 9","KT16 9","Total",6799,3396,3403,6735,64,82,436.18,15.6
"2011","KT17 1","KT17 1","Total",5362,2578,2784,5261,101,81,174.38,30.7
"2011","KT17 2","KT17 2","Total",7825,3827,3998,7825,0,157,340.32,23.0
"2011","KT17 3","KT17 3","Total",3970,1920,2050,3926,44,115,370.43,10.7
"2011","KT17 4","KT17 4","Total",6145,3026,3119,5711,434,113,205.24,29.9
"2011","KT18 5","KT18 5","Total",7921,3775,4146,7763,158,142,313.78,25.2
"2011","KT18 6","KT18 6","Total",2113,1056,1057,2102,11,51,974.61,2.2
"2011","KT18 7","KT18 7","Total",7411,3435,3976,7270,141,128,630.19,11.8
"2011","KT19 0","KT19 0","Total",9009,4458,4551,9009,0,141,227.21,39.7
"2011","KT19 7","KT19 7","Total",1849,914,935,1804,45,22,252.60,7.3
"2011","KT19 8","KT19 8","Total",7952,3859,4093,7818,134,134,263.74,30.2
"2011","KT19 9","KT19 9","Total",15288,7436,7852,15255,33,182,320.22,47.7
"2011","KT2  5","KT2  5","Total",14346,7072,7274,14045,301,277,221.88,64.7
"2011","KT2  6","KT2  6","Total",8123,4008,4115,8070,53,128,75.71,107.3
"2011","KT2  7","KT2  7","Total",7981,3801,4180,7299,682,213,317.59,25.1
"2011","KT20 5","KT20 5","Total",10331,4993,5338,10180,151,195,467.74,22.1
"2011","KT20 6","KT20 6","Total",5725,2781,2944,5585,140,132,963.36,5.9
"2011","KT20 7","KT20 7","Total",4503,2235,2268,4437,66,72,1893.85,2.4
"2011","KT21 1","KT21 1","Total",5858,2820,3038,5804,54,147,514.36,11.4
"2011","KT21 2","KT21 2","Total",7868,3772,4096,7677,191,215,631.52,12.5
"2011","KT22 0","KT22 0","Total",3921,1893,2028,3782,139,181,1089.19,3.6
"2011","KT22 7","KT22 7","Total",6518,3315,3203,6517,1,51,265.14,24.6
"2011","KT22 8","KT22 8","Total",4724,2311,2413,4539,185,144,649.64,7.3
"2011","KT22 9","KT22 9","Total",8991,4459,4532,8904,87,263,1011.77,8.9
"2011","KT23 3","KT23 3","Total",5090,2411,2679,5052,38,122,406.28,12.5
"2011","KT23 4","KT23 4","Total",5604,2665,2939,5580,24,127,666.88,8.4
"2011","KT24 5","KT24 5","Total",5233,2516,2717,5173,60,234,1822.77,2.9
"2011","KT24 6","KT24 6","Total",4282,2035,2247,4197,85,159,1192.55,3.6
"2011","KT3  3","KT3  3","Total",12688,6066,6622,12592,96,218,201.76,62.9
"2011","KT3  4","KT3  4","Total",4874,2393,2481,4846,28,174,161.45,30.2
"2011","KT3  5","KT3  5","Total",10083,4887,5196,9983,100,209,209.25,48.2
"2011","KT3  6","KT3  6","Total",10863,5366,5497,10750,113,166,226.87,47.9
"2011","KT4  7","KT4  7","Total",10554,5162,5392,10539,15,185,234.18,45.1
"2011","KT4  8","KT4  8","Total",18356,8996,9360,18305,51,211,315.47,58.2
"2011","KT5  8","KT5  8","Total",10780,5356,5424,10005,775,154,173.11,62.3
"2011","KT5  9","KT5  9","Total",9639,4787,4852,9639,0,175,271.34,35.5
"2011","KT6  4","KT6  4","Total",6235,3173,3062,6041,194,41,62.51,99.7
"2011","KT6  5","KT6  5","Total",7974,3865,4109,7272,702,139,223.61,35.7
"2011","KT6  6","KT6  6","Total",6726,3317,3409,6456,270,92,123.61,54.4
"2011","KT6  7","KT6  7","Total",10487,5071,5416,10405,82,134,249.68,42.0
"2011","KT7  0","KT7  0","Total",10365,4994,5371,10240,125,245,321.12,32.3
"2011","KT8  0","KT8  0","Total",2609,1310,1299,2565,44,87,193.87,13.5
"2011","KT8  1","KT8  1","Total",5487,2622,2865,5486,1,79,153.50,35.7
"2011","KT8  2","KT8  2","Total",7264,3479,3785,7229,35,68,135.92,53.4
"2011","KT8  9","KT8  9","Total",4286,2075,2211,4264,22,103,451.72,9.5
"2011","KT9  1","KT9  1","Total",9405,4555,4850,9387,18,119,197.73,47.6
"2011","KT9  2","KT9  2","Total",11964,5814,6150,11916,48,140,790.75,15.1
"2011","L1   0","L1   0","Total",143,69,74,143,0,0,2.09,68.4
"2011","L1   1","L1   1","Total",335,187,148,161,174,6,9.72,34.5
"2011","L1   2","L1   2","Total",161,88,73,138,23,2,1.05,153.3
"2011","L1   3","L1   3","Total",213,145,68,199,14,0,11.84,18.0
"2011","L1   4","L1   4","Total",1125,676,449,1059,66,6,20.61,54.6
"2011","L1   5","L1   5","Total",2333,1269,1064,2332,1,8,40.46,57.7
"2011","L1   6","L1   6","Total",402,238,164,396,6,3,28.69,14.0
"2011","L1   7","L1   7","Total",880,400,480,615,265,14,17.56,50.1
"2011","L1   8","L1   8","Total",746,464,282,746,0,13,7.72,96.6
"2011","L1   9","L1   9","Total",736,408,328,661,75,14,16.31,45.1
"2011","L10  0","L10  0","Total",505,250,255,505,0,3,8.65,58.4
"2011","L10  1","L10  1","Total",1509,739,770,1509,0,3,72.11,20.9
"2011","L10  2","L10  2","Total",1411,677,734,1411,0,4,137.36,10.3
"2011","L10  3","L10  3","Total",1182,574,608,1182,0,10,59.45,19.9
"2011","L10  4","L10  4","Total",3037,1495,1542,3003,34,9,202.76,15.0
"2011","L10  6","L10  6","Total",1510,716,794,1510,0,12,33.05,45.7
"2011","L10  7","L10  7","Total",2222,1032,1190,2222,0,5,32.31,68.8
"2011","L10  8","L10  8","Total",2088,1011,1077,2088,0,14,78.60,26.6
"2011","L10  9","L10  9","Total",1629,763,866,1629,0,8,66.83,24.4
"2011","L11  0","L11  0","Total",1593,720,873,1553,40,6,41.33,38.5
"2011","L11  1","L11  1","Total",2313,1059,1254,2313,0,11,76.57,30.2
"2011","L11  2","L11  2","Total",4155,1876,2279,4155,0,19,65.63,63.3
"2011","L11  3","L11  3","Total",4334,2040,2294,4334,0,13,63.28,68.5
"2011","L11  4","L11  4","Total",2904,1379,1525,2904,0,14,74.99,38.7
"2011","L11  5","L11  5","Total",1631,742,889,1631,0,6,22.69,71.9
"2011","L11  6","L11  6","Total",1105,500,605,1105,0,2,23.54,46.9
"2011","L11  7","L11  7","Total",3186,1476,1710,3183,3,10,47.07,67.7
"2011","L11  8","L11  8","Total",2061,971,1090,2051,10,14,38.66,53.3
"2011","L11  9","L11  9","Total",1944,880,1064,1802,142,5,84.93,22.9
"2011","L12  0","L12  0","Total",9668,4692,4976,9651,17,85,345.78,28.0
"2011","L12  1","L12  1","Total",1253,596,657,1253,0,16,53.17,23.6
"2011","L12  2","L12  2","Total",1066,540,526,1066,0,11,45.05,23.7
"2011","L12  3","L12  3","Total",964,471,493,948,16,13,23.51,41.0
"2011","L12  4","L12  4","Total",3020,1406,1614,3020,0,18,79.81,37.8
"2011","L12  5","L12  5","Total",4398,2087,2311,4398,0,36,181.95,24.2
"2011","L12  6","L12  6","Total",2232,1072,1160,2232,0,11,58.55,38.1
"2011","L12  7","L12  7","Total",2062,957,1105,2062,0,6,46.61,44.2
"2011","L12  8","L12  8","Total",2462,1182,1280,2454,8,23,38.88,63.3
"2011","L12  9","L12  9","Total",4672,2221,2451,4546,126,40,81.97,57.0
"2011","L13  0","L13  0","Total",1388,681,707,1388,0,4,26.57,52.2
"2011","L13  1","L13  1","Total",1589,773,816,1454,135,2,27.78,57.2
"2011","L13  2","L13  2","Total",3230,1563,1667,3190,40,15,45.78,70.6
"2011","L13  3","L13  3","Total",3116,1484,1632,3080,36,20,83.49,37.3
"2011","L13  4","L13  4","Total",3058,1529,1529,2977,81,16,50.70,60.3
"2011","L13  5","L13  5","Total",4117,1942,2175,4115,2,22,44.98,91.5
"2011","L13  6","L13  6","Total",3404,1677,1727,3401,3,26,33.04,103.0
"2011","L13  7","L13  7","Total",3953,2058,1895,3880,73,24,67.89,58.2
"2011","L13  8","L13  8","Total",3248,1638,1610,3245,3,4,38.18,85.1
"2011","L13  9","L13  9","Total",3462,1680,1782,3462,0,14,75.36,45.9
"2011","L14  0","L14  0","Total",4327,1979,2348,4327,0,17,53.86,80.3
"2011","L14  1","L14  1","Total",2179,1019,1160,2122,57,15,47.79,45.6
"2011","L14  2","L14  2","Total",2226,984,1242,2226,0,8,30.43,73.2
"2011","L14  3","L14  3","Total",1917,944,973,1883,34,17,61.04,31.4
"2011","L14  4","L14  4","Total",1699,741,958,1699,0,3,30.96,54.9
"2011","L14  5","L14  5","Total",962,477,485,924,38,12,35.82,26.9
"2011","L14  6","L14  6","Total",2725,1316,1409,2725,0,8,50.34,54.1
"2011","L14  7","L14  7","Total",3104,1451,1653,3072,32,17,63.78,48.7
"2011","L14  8","L14  8","Total",2407,1081,1326,2407,0,7,46.79,51.4
"2011","L14  9","L14  9","Total",3596,1665,1931,3496,100,11,54.51,66.0
"2011","L15  0","L15  0","Total",3219,1617,1602,3206,13,26,23.14,139.1
"2011","L15  1","L15  1","Total",2710,1326,1384,2707,3,7,30.40,89.1
"2011","L15  2","L15  2","Total",2484,1312,1172,2484,0,29,13.74,180.8
"2011","L15  3","L15  3","Total",4751,2389,2362,4741,10,46,43.87,108.3
"2011","L15  4","L15  4","Total",3977,2028,1949,3974,3,22,54.52,72.9
"2011","L15  5","L15  5","Total",1613,846,767,1611,2,12,25.73,62.7
"2011","L15  6","L15  6","Total",2493,1201,1292,2487,6,40,68.55,36.4
"2011","L15  7","L15  7","Total",3023,1423,1600,3023,0,25,65.32,46.3
"2011","L15  8","L15  8","Total",3851,1925,1926,3774,77,29,81.97,47.0
"2011","L15  9","L15  9","Total",1888,972,916,1885,3,23,23.60,80.0
"2011","L16  0","L16  0","Total",844,425,419,838,6,23,59.09,14.3
"2011","L16  1","L16  1","Total",1087,519,568,1087,0,2,18.72,58.1
"2011","L16  2","L16  2","Total",2527,1212,1315,2527,0,28,182.81,13.8
"2011","L16  3","L16  3","Total",2482,1232,1250,2481,1,19,43.47,57.1
"2011","L16  4","L16  4","Total",919,437,482,919,0,10,12.75,72.1
"2011","L16  5","L16  5","Total",1512,736,776,1511,1,16,41.04,36.8
"2011","L16  6","L16  6","Total",1159,555,604,1159,0,11,19.29,60.1
"2011","L16  7","L16  7","Total",2339,1148,1191,2336,3,37,39.13,59.8
"2011","L16  8","L16  8","Total",1043,475,568,1031,12,16,15.48,67.4
"2011","L16  9","L16  9","Total",1203,446,757,706,497,35,19.57,61.5
"2011","L17  0","L17  0","Total",4126,2005,2121,3996,130,29,92.05,44.8
"2011","L17  1","L17  1","Total",1024,503,521,594,430,15,42.13,24.3
"2011","L17  2","L17  2","Total",1631,814,817,1609,22,22,19.44,83.9
"2011","L17  3","L17  3","Total",2315,1266,1049,2282,33,12,69.21,33.4
"2011","L17  4","L17  4","Total",1502,791,711,1455,47,5,24.21,62.0
"2011","L17  5","L17  5","Total",1493,751,742,1468,25,16,140.25,10.6
"2011","L17  6","L17  6","Total",2291,1122,1169,2210,81,37,92.18,24.9
"2011","L17  7","L17  7","Total",4839,2318,2521,4468,371,44,81.40,59.4
"2011","L17  8","L17  8","Total",2918,1566,1352,2850,68,6,34.26,85.2
"2011","L17  9","L17  9","Total",2020,1008,1012,2018,2,17,20.71,97.5
"2011","L18  0","L18  0","Total",1028,502,526,1028,0,21,12.15,84.6
"2011","L18  1","L18  1","Total",6068,2947,3121,6065,3,67,54.56,111.2
"2011","L18  2","L18  2","Total",1968,912,1056,1939,29,41,45.03,43.7
"2011","L18  3","L18  3","Total",3107,1513,1594,3079,28,81,125.48,24.8
"2011","L18  4","L18  4","Total",2298,1127,1171,2298,0,32,56.54,40.6
"2011","L18  5","L18  5","Total",2375,1125,1250,2375,0,27,34.28,69.3
"2011","L18  6","L18  6","Total",1704,816,888,1675,29,51,87.72,19.4
"2011","L18  7","L18  7","Total",2855,1399,1456,2855,0,35,82.41,34.6
"2011","L18  8","L18  8","Total",3545,1709,1836,2191,1354,53,70.94,50.0
"2011","L18  9","L18  9","Total",3465,1724,1741,3454,11,56,76.78,45.1
"2011","L19  0","L19  0","Total",2129,1104,1025,2073,56,41,70.31,30.3
"2011","L19  1","L19  1","Total",2746,1335,1411,2727,19,23,36.97,74.3
"2011","L19  2","L19  2","Total",3072,1525,1547,3072,0,13,188.95,16.3
"2011","L19  3","L19  3","Total",2785,1363,1422,2717,68,52,64.03,43.5
"2011","L19  4","L19  4","Total",2879,1345,1534,2879,0,18,51.77,55.6
"2011","L19  5","L19  5","Total",1563,748,815,1563,0,5,134.45,11.6
"2011","L19  6","L19  6","Total",1102,586,516,1092,10,3,28.00,39.4
"2011","L19  7","L19  7","Total",1251,590,661,1251,0,11,20.41,61.3
"2011","L19  8","L19  8","Total",3112,1517,1595,3112,0,11,115.11,27.0
"2011","L19  9","L19  9","Total",3090,1482,1608,3071,19,40,52.97,58.3
"2011","L2   0","L2   0","Total",200,108,92,200,0,2,12.33,16.2
"2011","L2   2","L2   2","Total",169,101,68,169,0,1,0.68,248.5
"2011","L2   5","L2   5","Total",197,125,72,197,0,1,1.92,102.6
"2011","L20  0","L20  0","Total",3311,1574,1737,3303,8,31,75.86,43.6
"2011","L20  2","L20  2","Total",2426,1190,1236,2421,5,12,34.45,70.4
"2011","L20  3","L20  3","Total",2545,1264,1281,2474,71,3,63.03,40.4
"2011","L20  4","L20  4","Total",6387,3168,3219,6344,43,19,135.30,47.2
"2011","L20  5","L20  5","Total",2903,1377,1526,2891,12,15,48.99,59.3
"2011","L20  6","L20  6","Total",5267,2507,2760,5232,35,20,137.94,38.2
"2011","L20  7","L20  7","Total",2019,1040,979,1902,117,7,49.13,41.1
"2011","L20  8","L20  8","Total",380,190,190,380,0,2,188.66,2.0
"2011","L20  9","L20  9","Total",6327,2996,3331,6288,39,38,102.31,61.8
"2011","L21  0","L21  0","Total",3670,1737,1933,3670,0,26,152.54,24.1
"2011","L21  1","L21  1","Total",3682,1803,1879,3614,68,30,64.07,57.5
"2011","L21  2","L21  2","Total",1104,521,583,1104,0,2,89.93,12.3
"2011","L21  3","L21  3","Total",545,259,286,544,1,3,12.19,44.7
"2011","L21  4","L21  4","Total",1743,832,911,1742,1,11,131.34,13.3
"2011","L21  5","L21  5","Total",1947,946,1001,1947,0,10,30.98,62.8
"2011","L21  6","L21  6","Total",1006,445,561,1006,0,6,17.23,58.4
"2011","L21  7","L21  7","Total",3583,1707,1876,3583,0,13,48.59,73.7
"2011","L21  8","L21  8","Total",3347,1634,1713,3347,0,11,48.45,69.1
"2011","L21  9","L21  9","Total",4929,2353,2576,4927,2,35,83.10,59.3
"2011","L22  0","L22  0","Total",1339,679,660,1323,16,8,22.13,60.5
"2011","L22  1","L22  1","Total",833,413,420,758,75,8,16.76,49.7
"2011","L22  2","L22  2","Total",1851,875,976,1851,0,39,20.34,91.0
"2011","L22  3","L22  3","Total",1113,529,584,1044,69,9,24.20,46.0
"2011","L22  4","L22  4","Total",2186,1071,1115,2186,0,23,24.92,87.7
"2011","L22  5","L22  5","Total",1187,655,532,1187,0,5,108.79,10.9
"2011","L22  6","L22  6","Total",1381,678,703,1381,0,7,22.09,62.5
"2011","L22  7","L22  7","Total",1227,609,618,1227,0,13,24.24,50.6
"2011","L22  8","L22  8","Total",1259,632,627,1231,28,17,58.04,21.7
"2011","L22  9","L22  9","Total",1417,686,731,1417,0,11,22.28,63.6
"2011","L23  0","L23  0","Total",4875,2317,2558,4820,55,61,83.72,58.2
"2011","L23  1","L23  1","Total",2177,969,1208,2079,98,17,188.47,11.6
"2011","L23  2","L23  2","Total",3259,1583,1676,3225,34,56,127.50,25.6
"2011","L23  3","L23  3","Total",2473,1151,1322,2448,25,38,32.04,77.2
"2011","L23  4","L23  4","Total",1144,580,564,1144,0,18,586.88,1.9
"2011","L23  5","L23  5","Total",2296,1102,1194,2296,0,44,44.20,51.9
"2011","L23  6","L23  6","Total",3124,1440,1684,2992,132,60,162.90,19.2
"2011","L23  7","L23  7","Total",3044,1432,1612,3044,0,62,80.32,37.9
"2011","L23  8","L23  8","Total",2118,1006,1112,2108,10,65,196.04,10.8
"2011","L23  9","L23  9","Total",5711,2701,3010,5711,0,70,101.81,56.1
"2011","L24  0","L24  0","Total",2892,1320,1572,2892,0,11,58.94,49.1
"2011","L24  1","L24  1","Total",1202,566,636,1171,31,2,531.41,2.3
"2011","L24  2","L24  2","Total",3176,1457,1719,3141,35,11,75.96,41.8
"2011","L24  3","L24  3","Total",3003,1435,1568,3003,0,5,178.05,16.9
"2011","L24  4","L24  4","Total",902,445,457,902,0,9,305.50,3.0
"2011","L24  5","L24  5","Total",939,461,478,939,0,9,273.48,3.4
"2011","L24  6","L24  6","Total",1143,529,614,1143,0,2,26.39,43.3
"2011","L24  7","L24  7","Total",1777,856,921,1777,0,7,42.75,41.6
"2011","L24  9","L24  9","Total",930,448,482,930,0,1,23.07,40.3
"2011","L25  0","L25  0","Total",3240,1596,1644,3235,5,25,151.15,21.4
"2011","L25  1","L25  1","Total",1789,896,893,1789,0,8,45.57,39.3
"2011","L25  2","L25  2","Total",3708,1698,2010,3681,27,15,85.85,43.2
"2011","L25  3","L25  3","Total",3195,1594,1601,3192,3,16,99.61,32.1
"2011","L25  4","L25  4","Total",2736,1326,1410,2725,11,35,97.49,28.1
"2011","L25  5","L25  5","Total",4310,2052,2258,4310,0,45,99.95,43.1
"2011","L25  6","L25  6","Total",1716,839,877,1712,4,43,61.22,28.0
"2011","L25  7","L25  7","Total",4498,2157,2341,4326,172,53,252.93,17.8
"2011","L25  8","L25  8","Total",3728,1798,1930,3725,3,33,79.35,47.0
"2011","L25  9","L25  9","Total",4527,2120,2407,4367,160,23,91.50,49.5
"2011","L26  0","L26  0","Total",2241,1093,1148,2241,0,16,53.44,41.9
"2011","L26  1","L26  1","Total",3186,1526,1660,3186,0,14,77.45,41.1
"2011","L26  3","L26  3","Total",246,115,131,246,0,1,269.45,0.9
"2011","L26  6","L26  6","Total",1498,726,772,1498,0,16,55.89,26.8
"2011","L26  7","L26  7","Total",4833,2398,2435,4833,0,30,235.47,20.5
"2011","L26  9","L26  9","Total",3146,1503,1643,3142,4,12,223.77,14.1
"2011","L27  0","L27  0","Total",341,162,179,341,0,2,45.64,7.5
"2011","L27  1","L27  1","Total",1129,504,625,1129,0,3,43.17,26.2
"2011","L27  4","L27  4","Total",245,116,129,239,6,0,7.13,34.4
"2011","L27  5","L27  5","Total",1251,567,684,1251,0,8,15.69,79.7
"2011","L27  6","L27  6","Total",1084,490,594,1055,29,2,53.99,20.1
"2011","L27  7","L27  7","Total",1321,592,729,1273,48,4,33.48,39.5
"2011","L27  8","L27  8","Total",1056,493,563,1056,0,2,52.58,20.1
"2011","L28  0","L28  0","Total",1005,450,555,1005,0,4,25.17,39.9
"2011","L28  1","L28  1","Total",1421,649,772,1421,0,4,33.32,42.6
"2011","L28  3","L28  3","Total",244,124,120,244,0,2,12.14,20.1
"2011","L28  4","L28  4","Total",1439,687,752,1439,0,3,45.29,31.8
"2011","L28  5","L28  5","Total",924,483,441,924,0,3,10.31,89.6
"2011","L28  6","L28  6","Total",458,207,251,458,0,0,8.53,53.7
"2011","L28  7","L28  7","Total",247,127,120,247,0,1,7.35,33.6
"2011","L28  8","L28  8","Total",536,246,290,536,0,4,21.67,24.7
"2011","L29  7","L29  7","Total",404,192,212,404,0,2,489.98,0.8
"2011","L3   0","L3   0","Total",591,364,227,585,6,3,29.71,19.9
"2011","L3   1","L3   1","Total",881,579,302,881,0,2,30.21,29.2
"2011","L3   2","L3   2","Total",2506,1394,1112,1441,1065,47,23.54,106.5
"2011","L3   3","L3   3","Total",390,194,196,390,0,0,22.96,17.0
"2011","L3   4","L3   4","Total",2805,1668,1137,2800,5,14,113.20,24.8
"2011","L3   5","L3   5","Total",3363,1505,1858,1416,1947,57,40.07,83.9
"2011","L3   6","L3   6","Total",3579,1844,1735,2720,859,46,259.86,13.8
"2011","L3   8","L3   8","Total",2549,1274,1275,1513,1036,44,44.98,56.7
"2011","L3   9","L3   9","Total",1166,743,423,1165,1,1,19.09,61.1
"2011","L30  0","L30  0","Total",2172,1008,1164,2145,27,11,55.05,39.5
"2011","L30  1","L30  1","Total",4077,1943,2134,4077,0,24,152.03,26.8
"2011","L30  2","L30  2","Total",3287,1505,1782,3085,202,16,64.02,51.3
"2011","L30  3","L30  3","Total",1912,902,1010,1912,0,11,84.40,22.7
"2011","L30  5","L30  5","Total",3070,1395,1675,3070,0,23,61.27,50.1
"2011","L30  6","L30  6","Total",325,167,158,325,0,4,19.12,17.0
"2011","L30  7","L30  7","Total",2738,1307,1431,2735,3,21,68.68,39.9
"2011","L30  8","L30  8","Total",1408,671,737,1408,0,8,48.82,28.8
"2011","L30  9","L30  9","Total",883,429,454,883,0,2,15.96,55.3
"2011","L31  0","L31  0","Total",2423,1162,1261,2423,0,26,54.45,44.5
"2011","L31  1","L31  1","Total",4501,2428,2073,4032,469,27,911.16,4.9
"2011","L31  2","L31  2","Total",3112,1453,1659,3109,3,31,221.43,14.1
"2011","L31  3","L31  3","Total",1423,662,761,1396,27,10,228.70,6.2
"2011","L31  4","L31  4","Total",2401,1153,1248,2375,26,30,408.77,5.9
"2011","L31  5","L31  5","Total",3732,1789,1943,3726,6,32,68.42,54.5
"2011","L31  6","L31  6","Total",3248,1543,1705,3179,69,31,87.03,37.3
"2011","L31  7","L31  7","Total",2951,1420,1531,2925,26,31,82.37,35.8
"2011","L31  8","L31  8","Total",2951,1442,1509,2949,2,24,209.20,14.1
"2011","L31  9","L31  9","Total",4059,1933,2126,4059,0,45,110.66,36.7
"2011","L32  0","L32  0","Total",3238,1480,1758,3199,39,4,82.31,39.3
"2011","L32  1","L32  1","Total",1457,685,772,1457,0,3,50.52,28.8
"2011","L32  2","L32  2","Total",2201,1086,1115,2201,0,13,50.92,43.2
"2011","L32  3","L32  3","Total",1313,616,697,1313,0,4,40.99,32.0
"2011","L32  4","L32  4","Total",1934,911,1023,1934,0,12,57.30,33.8
"2011","L32  5","L32  5","Total",776,341,435,776,0,3,12.46,62.3
"2011","L32  6","L32  6","Total",2111,1048,1063,2111,0,8,162.06,13.0
"2011","L32  7","L32  7","Total",2080,965,1115,2080,0,2,64.10,32.4
"2011","L32  8","L32  8","Total",2140,956,1184,2140,0,4,65.14,32.9
"2011","L32  9","L32  9","Total",3197,1525,1672,3197,0,15,151.68,21.1
"2011","L33  0","L33  0","Total",1071,516,555,1071,0,2,17.61,60.8
"2011","L33  1","L33  1","Total",4823,2222,2601,4823,0,15,113.98,42.3
"2011","L33  2","L33  2","Total",1163,540,623,1163,0,6,23.92,48.6
"2011","L33  4","L33  4","Total",3988,1912,2076,3988,0,14,895.02,4.5
"2011","L33  5","L33  5","Total",1315,608,707,1313,2,4,171.78,7.7
"2011","L33  6","L33  6","Total",1419,614,805,1369,50,2,26.13,54.3
"2011","L33  7","L33  7","Total",268,135,133,268,0,3,448.89,0.6
"2011","L33  8","L33  8","Total",989,504,485,989,0,2,34.00,29.1
"2011","L33  9","L33  9","Total",1903,787,1116,1897,6,2,150.58,12.6
"2011","L34  0","L34  0","Total",2444,1205,1239,2444,0,26,249.62,9.8
"2011","L34  1","L34  1","Total",2004,1038,966,2004,0,15,147.12,13.6
"2011","L34  2","L34  2","Total",3351,1597,1754,3323,28,52,79.65,42.1
"2011","L34  3","L34  3","Total",687,331,356,644,43,1,39.77,17.3
"2011","L34  4","L34  4","Total",369,173,196,369,0,6,1275.20,0.3
"2011","L34  5","L34  5","Total",1312,644,668,1268,44,13,37.58,34.9
"2011","L34  6","L34  6","Total",1848,864,984,1848,0,17,202.05,9.1
"2011","L35  0","L35  0","Total",2619,1249,1370,2544,75,34,91.34,28.7
"2011","L35  1","L35  1","Total",1431,702,729,1431,0,13,1098.02,1.3
"2011","L35  2","L35  2","Total",2255,1068,1187,2253,2,8,54.81,41.1
"2011","L35  3","L35  3","Total",7600,3681,3919,7600,0,32,412.26,18.4
"2011","L35  4","L35  4","Total",2950,1445,1505,2906,44,36,132.76,22.2
"2011","L35  5","L35  5","Total",5335,2564,2771,5315,20,38,95.10,56.1
"2011","L35  6","L35  6","Total",1444,722,722,1444,0,34,224.22,6.4
"2011","L35  7","L35  7","Total",2761,1338,1423,2714,47,31,64.28,43.0
"2011","L35  8","L35  8","Total",3002,1495,1507,2961,41,20,67.66,44.4
"2011","L35  9","L35  9","Total",1667,799,868,1619,48,8,214.29,7.8
"2011","L36  0","L36  0","Total",4433,2072,2361,4429,4,29,117.18,37.8
"2011","L36  1","L36  1","Total",2731,1318,1413,2731,0,28,92.75,29.4
"2011","L36  2","L36  2","Total",5088,2363,2725,5083,5,16,81.29,62.6
"2011","L36  3","L36  3","Total",4626,2177,2449,4561,65,13,92.02,50.3
"2011","L36  4","L36  4","Total",6407,3078,3329,6367,40,54,129.79,49.4
"2011","L36  5","L36  5","Total",4308,2023,2285,4129,179,37,185.82,23.2
"2011","L36  6","L36  6","Total",2522,1168,1354,2508,14,8,80.39,31.4
"2011","L36  7","L36  7","Total",3692,1726,1966,3668,24,14,70.98,52.0
"2011","L36  8","L36  8","Total",4639,2179,2460,4595,44,21,317.89,14.6
"2011","L36  9","L36  9","Total",1483,680,803,1446,37,14,44.14,33.6
"2011","L37  1","L37  1","Total",2309,1092,1217,2215,94,54,383.58,6.0
"2011","L37  2","L37  2","Total",5047,2441,2606,4985,62,109,474.96,10.6
"2011","L37  3","L37  3","Total",4831,2261,2570,4763,68,107,200.52,24.1
"2011","L37  4","L37  4","Total",2671,1286,1385,2665,6,49,121.26,22.0
"2011","L37  5","L37  5","Total",213,105,108,213,0,3,1448.99,0.1
"2011","L37  6","L37  6","Total",2915,1396,1519,2913,2,31,296.89,9.8
"2011","L37  7","L37  7","Total",3594,1733,1861,3562,32,83,933.52,3.8
"2011","L37  8","L37  8","Total",1962,934,1028,1962,0,31,44.92,43.7
"2011","L38  0","L38  0","Total",520,260,260,520,0,7,59.01,8.8
"2011","L38  1","L38  1","Total",295,131,164,262,33,1,861.84,0.3
"2011","L38  3","L38  3","Total",332,167,165,332,0,11,148.63,2.2
"2011","L38  6","L38  6","Total",221,106,115,221,0,3,69.46,3.2
"2011","L38  9","L38  9","Total",1211,589,622,1211,0,29,80.21,15.1
"2011","L39  0","L39  0","Total",1180,581,599,1180,0,21,2436.65,0.5
"2011","L39  1","L39  1","Total",4957,2398,2559,4895,62,59,231.14,21.4
"2011","L39  2","L39  2","Total",3346,1589,1757,3286,60,64,317.04,10.6
"2011","L39  3","L39  3","Total",3136,1488,1648,3136,0,41,217.03,14.4
"2011","L39  4","L39  4","Total",6700,3099,3601,5751,949,136,445.46,15.0
"2011","L39  5","L39  5","Total",4667,2258,2409,4571,96,96,299.15,15.6
"2011","L39  6","L39  6","Total",2167,1032,1135,2079,88,42,828.02,2.6
"2011","L39  7","L39  7","Total",1173,580,593,1157,16,22,2041.39,0.6
"2011","L39  8","L39  8","Total",1350,665,685,1350,0,17,2448.91,0.6
"2011","L4   0","L4   0","Total",2986,1527,1459,2926,60,8,77.88,38.3
"2011","L4   1","L4   1","Total",3267,1640,1627,3232,35,18,50.58,64.6
"2011","L4   2","L4   2","Total",5717,2721,2996,5677,40,20,45.44,125.8
"2011","L4   3","L4   3","Total",3652,1754,1898,3624,28,9,37.68,96.9
"2011","L4   4","L4   4","Total",4012,2052,1960,3978,34,17,57.39,69.9
"2011","L4   5","L4   5","Total",6197,2993,3204,6195,2,19,59.91,103.4
"2011","L4   6","L4   6","Total",2823,1377,1446,2821,2,11,52.10,54.2
"2011","L4   7","L4   7","Total",3450,1660,1790,3450,0,12,91.75,37.6
"2011","L4   8","L4   8","Total",2654,1265,1389,2640,14,9,47.65,55.7
"2011","L4   9","L4   9","Total",5510,2530,2980,5508,2,13,114.98,47.9
"2011","L40  0","L40  0","Total",1220,604,616,1220,0,16,910.71,1.3
"2011","L40  1","L40  1","Total",2049,1028,1021,2018,31,39,1262.85,1.6
"2011","L40  2","L40  2","Total",1047,519,528,1047,0,21,954.67,1.1
"2011","L40  3","L40  3","Total",1208,590,618,1208,0,25,895.69,1.3
"2011","L40  4","L40  4","Total",1648,822,826,1648,0,31,1039.40,1.6
"2011","L40  5","L40  5","Total",2621,1289,1332,2590,31,29,1005.18,2.6
"2011","L40  6","L40  6","Total",1052,518,534,1048,4,14,762.49,1.4
"2011","L40  7","L40  7","Total",4918,2405,2513,4837,81,45,679.99,7.2
"2011","L40  8","L40  8","Total",1007,508,499,952,55,12,910.48,1.1
"2011","L40  9","L40  9","Total",1263,629,634,1263,0,6,1763.53,0.7
"2011","L5   0","L5   0","Total",1867,890,977,1867,0,10,35.53,52.5
"2011","L5   1","L5   1","Total",529,247,282,524,5,1,10.92,48.4
"2011","L5   2","L5   2","Total",811,372,439,777,34,1,18.81,43.1
"2011","L5   3","L5   3","Total",1667,906,761,1667,0,6,63.29,26.3
"2011","L5   4","L5   4","Total",1295,626,669,1295,0,5,22.27,58.1
"2011","L5   5","L5   5","Total",849,455,394,838,11,3,41.34,20.5
"2011","L5   6","L5   6","Total",2301,1123,1178,2298,3,8,20.91,110.0
"2011","L5   7","L5   7","Total",1356,664,692,1356,0,7,21.59,62.8
"2011","L5   8","L5   8","Total",791,391,400,791,0,0,15.23,51.9
"2011","L5   9","L5   9","Total",982,480,502,982,0,6,124.10,7.9
"2011","L6   0","L6   0","Total",2734,1300,1434,2638,96,17,35.17,77.7
"2011","L6   1","L6   1","Total",2546,1232,1314,1519,1027,50,35.24,72.2
"2011","L6   2","L6   2","Total",2398,1121,1277,2394,4,9,59.72,40.2
"2011","L6   3","L6   3","Total",2031,1164,867,2023,8,5,23.13,87.8
"2011","L6   4","L6   4","Total",3691,1969,1722,3626,65,6,42.84,86.2
"2011","L6   5","L6   5","Total",2803,1422,1381,2785,18,8,41.96,66.8
"2011","L6   6","L6   6","Total",3569,1805,1764,3569,0,9,22.85,156.2
"2011","L6   7","L6   7","Total",633,408,225,626,7,1,12.30,51.5
"2011","L6   8","L6   8","Total",1925,1018,907,1881,44,18,67.77,28.4
"2011","L6   9","L6   9","Total",1397,681,716,1397,0,6,20.44,68.3
"2011","L7   0","L7   0","Total",3304,1703,1601,3269,35,25,130.39,25.3
"2011","L7   1","L7   1","Total",221,104,117,221,0,0,10.52,21.0
"2011","L7   2","L7   2","Total",1913,980,933,1898,15,18,27.15,70.5
"2011","L7   3","L7   3","Total",2823,1389,1434,2294,529,32,48.98,57.6
"2011","L7   4","L7   4","Total",440,232,208,440,0,1,5.20,84.6
"2011","L7   5","L7   5","Total",933,535,398,915,18,6,17.26,54.1
"2011","L7   6","L7   6","Total",1894,957,937,1894,0,4,51.62,36.7
"2011","L7   7","L7   7","Total",2456,1276,1180,1138,1318,50,41.07,59.8
"2011","L7   8","L7   8","Total",3654,1895,1759,3590,64,17,46.20,79.1
"2011","L7   9","L7   9","Total",368,181,187,368,0,4,3.01,122.3
"2011","L8   0","L8   0","Total",7331,3910,3421,7242,89,41,85.21,86.0
"2011","L8   1","L8   1","Total",1188,613,575,1185,3,7,19.72,60.2
"2011","L8   2","L8   2","Total",1764,890,874,1734,30,11,25.12,70.2
"2011","L8   3","L8   3","Total",2682,1587,1095,2504,178,11,48.53,55.3
"2011","L8   4","L8   4","Total",4021,1961,2060,4021,0,16,47.79,84.1
"2011","L8   5","L8   5","Total",1839,906,933,1773,66,10,33.99,54.1
"2011","L8   6","L8   6","Total",2386,1143,1243,2386,0,4,74.33,32.1
"2011","L8   7","L8   7","Total",4467,2608,1859,4078,389,42,41.37,108.0
"2011","L8   8","L8   8","Total",4355,2115,2240,4299,56,16,52.34,83.2
"2011","L8   9","L8   9","Total",2544,1247,1297,2485,59,2,35.16,72.4
"2011","L9   0","L9   0","Total",4115,2035,2080,4115,0,19,60.59,67.9
"2011","L9   1","L9   1","Total",6398,3284,3114,6398,0,9,157.39,40.7
"2011","L9   2","L9   2","Total",2825,1419,1406,2825,0,10,41.98,67.3
"2011","L9   3","L9   3","Total",3563,2173,1390,2764,799,12,53.81,66.2
"2011","L9   4","L9   4","Total",877,408,469,877,0,1,10.20,86.0
"2011","L9   6","L9   6","Total",3533,1724,1809,3533,0,11,107.45,32.9
"2011","L9   7","L9   7","Total",1724,1200,524,971,753,9,183.25,9.4
"2011","L9   8","L9   8","Total",4550,2268,2282,4530,20,34,74.43,61.1
"2011","L9   9","L9   9","Total",5052,2443,2609,5027,25,17,95.92,52.7
"2011","LA1  1","LA1  1","Total",5655,2833,2822,5208,447,74,119.67,47.3
"2011","LA1  2","LA1  2","Total",11028,5334,5694,11021,7,100,242.38,45.5
"2011","LA1  3","LA1  3","Total",10133,5047,5086,9176,957,144,409.27,24.8
"2011","LA1  4","LA1  4","Total",15715,7566,8149,12447,3268,234,1237.81,12.7
"2011","LA1  5","LA1  5","Total",9518,4439,5079,8960,558,199,546.54,17.4
"2011","LA10 5","LA10 5","Total",4002,2066,1936,3550,452,90,27434.11,0.1
"2011","LA11 6","LA11 6","Total",3717,1784,1933,3631,86,59,6225.21,0.6
"2011","LA11 7","LA11 7","Total",5956,2848,3108,5803,153,92,4428.70,1.3
"2011","LA12 0","LA12 0","Total",6055,2963,3092,6023,32,119,4052.32,1.5
"2011","LA12 7","LA12 7","Total",4456,2208,2248,4445,11,83,3008.82,1.5
"2011","LA12 8","LA12 8","Total",2414,1229,1185,2368,46,54,15464.61,0.2
"2011","LA12 9","LA12 9","Total",7269,3525,3744,7067,202,90,1434.63,5.1
"2011","LA13 0","LA13 0","Total",8774,4335,4439,8772,2,134,2156.51,4.1
"2011","LA13 9","LA13 9","Total",10038,4957,5081,9931,107,127,340.70,29.5
"2011","LA14 1","LA14 1","Total",3342,1711,1631,3309,33,21,146.41,22.8
"2011","LA14 2","LA14 2","Total",7199,3660,3539,7057,142,40,377.55,19.1
"2011","LA14 3","LA14 3","Total",10651,5185,5466,10592,59,84,1327.30,8.0
"2011","LA14 4","LA14 4","Total",6545,3192,3353,6452,93,75,786.51,8.3
"2011","LA14 5","LA14 5","Total",10776,5318,5458,10594,182,117,216.47,49.8
"2011","LA15 8","LA15 8","Total",7827,3863,3964,7782,45,91,609.80,12.8
"2011","LA16 7","LA16 7","Total",3462,1723,1739,3430,32,45,1923.14,1.8
"2011","LA17 7","LA17 7","Total",1174,577,597,1174,0,10,3901.39,0.3
"2011","LA18 4","LA18 4","Total",5730,3091,2639,5142,588,45,4836.23,1.2
"2011","LA18 5","LA18 5","Total",3340,1630,1710,3303,37,40,4661.25,0.7
"2011","LA19 5","LA19 5","Total",972,475,497,958,14,10,5275.31,0.2
"2011","LA2  0","LA2  0","Total",6012,2926,3086,3660,2352,108,4998.52,1.2
"2011","LA2  6","LA2  6","Total",5403,2537,2866,5228,175,98,2449.51,2.2
"2011","LA2  7","LA2  7","Total",3027,1513,1514,3004,23,62,3122.12,1.0
"2011","LA2  8","LA2  8","Total",3321,1646,1675,3258,63,90,18738.98,0.2
"2011","LA2  9","LA2  9","Total",4541,2231,2310,4465,76,74,18879.40,0.2
"2011","LA20 6","LA20 6","Total",1159,581,578,1159,0,37,12235.89,0.1
"2011","LA21 8","LA21 8","Total",928,464,464,899,29,20,4093.32,0.2
"2011","LA22 0","LA22 0","Total",2170,1070,1100,2031,139,27,4961.07,0.4
"2011","LA22 9","LA22 9","Total",2773,1380,1393,2531,242,57,8899.81,0.3
"2011","LA23 1","LA23 1","Total",2785,1295,1490,2421,364,49,5944.98,0.5
"2011","LA23 2","LA23 2","Total",4048,1984,2064,3957,91,84,366.74,11.0
"2011","LA23 3","LA23 3","Total",2304,1161,1143,2116,188,34,2574.62,0.9
"2011","LA3  1","LA3  1","Total",8377,4117,4260,8187,190,72,139.30,60.1
"2011","LA3  2","LA3  2","Total",10197,4934,5263,10139,58,89,643.18,15.9
"2011","LA3  3","LA3  3","Total",5873,2861,3012,5827,46,75,2334.16,2.5
"2011","LA4  4","LA4  4","Total",9174,4421,4753,9085,89,59,256.61,35.8
"2011","LA4  5","LA4  5","Total",9335,4504,4831,8975,360,45,192.72,48.4
"2011","LA4  6","LA4  6","Total",7883,3616,4267,7757,126,91,234.31,33.6
"2011","LA5  0","LA5  0","Total",3853,1837,2016,3760,93,59,2058.69,1.9
"2011","LA5  8","LA5  8","Total",4127,1990,2137,4107,20,64,668.87,6.2
"2011","LA5  9","LA5  9","Total",8436,4051,4385,8331,105,88,3844.15,2.2
"2011","LA6  1","LA6  1","Total",5106,2492,2614,5098,8,86,6281.85,0.8
"2011","LA6  2","LA6  2","Total",4347,2053,2294,4045,302,119,14897.29,0.3
"2011","LA6  3","LA6  3","Total",3053,1464,1589,3004,49,47,10730.98,0.3
"2011","LA7  7","LA7  7","Total",5317,2559,2758,5073,244,89,5069.19,1.0
"2011","LA8  0","LA8  0","Total",2992,1460,1532,2992,0,58,7001.44,0.4
"2011","LA8  8","LA8  8","Total",2669,1336,1333,2618,51,41,9799.76,0.3
"2011","LA8  9","LA8  9","Total",3347,1652,1695,3320,27,67,18318.48,0.2
"2011","LA9  4","LA9  4","Total",4010,1963,2047,3879,131,39,98.20,40.8
"2011","LA9  5","LA9  5","Total",9346,4499,4847,9208,138,163,349.97,26.7
"2011","LA9  6","LA9  6","Total",6982,3362,3620,6950,32,107,730.88,9.6
"2011","LA9  7","LA9  7","Total",10061,4921,5140,9927,134,160,827.75,12.2
"2011","LE1  1","LE1  1","Total",1716,961,755,1716,0,4,17.21,99.7
"2011","LE1  2","LE1  2","Total",4275,2067,2208,4274,1,27,33.32,128.3
"2011","LE1  3","LE1  3","Total",666,394,272,666,0,2,65.60,10.2
"2011","LE1  4","LE1  4","Total",656,365,291,656,0,3,85.57,7.7
"2011","LE1  5","LE1  5","Total",1989,1031,958,1172,817,33,38.44,51.7
"2011","LE1  6","LE1  6","Total",2978,1468,1510,2266,712,48,33.61,88.6
"2011","LE1  7","LE1  7","Total",1028,465,563,448,580,17,25.72,40.0
"2011","LE10 0","LE10 0","Total",20354,10120,10234,20306,48,142,993.39,20.5
"2011","LE10 1","LE10 1","Total",10327,5141,5186,10179,148,147,535.67,19.3
"2011","LE10 2","LE10 2","Total",14568,7046,7522,14521,47,178,1256.87,11.6
"2011","LE10 3","LE10 3","Total",2225,1112,1113,2225,0,36,3380.99,0.7
"2011","LE11 1","LE11 1","Total",9835,5099,4736,9689,146,96,526.33,18.7
"2011","LE11 2","LE11 2","Total",13840,6777,7063,13776,64,188,521.93,26.5
"2011","LE11 3","LE11 3","Total",16441,9018,7423,10814,5627,403,1033.75,15.9
"2011","LE11 4","LE11 4","Total",9722,4949,4773,9617,105,153,466.61,20.8
"2011","LE11 5","LE11 5","Total",10529,5442,5087,10331,198,128,463.04,22.7
"2011","LE12 5","LE12 5","Total",7482,3567,3915,6895,587,146,6853.11,1.1
"2011","LE12 6","LE12 6","Total",9193,4434,4759,9142,51,158,4538.47,2.0
"2011","LE12 7","LE12 7","Total",16604,8159,8445,16429,175,190,2358.54,7.0
"2011","LE12 8","LE12 8","Total",13957,6844,7113,13577,380,274,4304.17,3.2
"2011","LE12 9","LE12 9","Total",14886,7319,7567,14565,321,199,4645.19,3.2
"2011","LE13 0","LE13 0","Total",15198,7429,7769,14967,231,135,1423.26,10.7
"2011","LE13 1","LE13 1","Total",11960,5884,6076,11899,61,134,882.93,13.5
"2011","LE14 2","LE14 2","Total",4514,2285,2229,4495,19,103,12997.54,0.3
"2011","LE14 3","LE14 3","Total",6621,3206,3415,6583,38,100,8764.13,0.8
"2011","LE14 4","LE14 4","Total",6186,3032,3154,6112,74,137,13468.40,0.5
"2011","LE15 6","LE15 6","Total",10922,5260,5662,10432,490,201,909.00,12.0
"2011","LE15 7","LE15 7","Total",8135,4488,3647,7073,1062,183,12495.27,0.7
"2011","LE15 8","LE15 8","Total",6416,3274,3142,5954,462,172,14244.65,0.5
"2011","LE15 9","LE15 9","Total",6852,3401,3451,5856,996,180,6402.04,1.1
"2011","LE16 7","LE16 7","Total",11868,6154,5714,11076,792,220,7408.14,1.6
"2011","LE16 8","LE16 8","Total",10331,5034,5297,10224,107,240,16368.73,0.6
"2011","LE16 9","LE16 9","Total",12776,6236,6540,12597,179,228,4928.48,2.6
"2011","LE17 4","LE17 4","Total",10597,5286,5311,10521,76,170,4185.40,2.5
"2011","LE17 5","LE17 5","Total",6117,3076,3041,6117,0,138,7374.26,0.8
"2011","LE17 6","LE17 6","Total",3934,1962,1972,3857,77,85,7173.81,0.5
"2011","LE18 1","LE18 1","Total",7885,3770,4115,7770,115,72,152.90,51.6
"2011","LE18 2","LE18 2","Total",8628,4092,4536,8494,134,81,342.50,25.2
"2011","LE18 3","LE18 3","Total",8171,4058,4113,8165,6,115,1518.21,5.4
"2011","LE18 4","LE18 4","Total",8177,4220,3957,7539,638,43,334.88,24.4
"2011","LE19 2","LE19 2","Total",5916,2879,3037,5865,51,48,555.53,10.6
"2011","LE19 3","LE19 3","Total",4741,2350,2391,4735,6,89,331.76,14.3
"2011","LE19 4","LE19 4","Total",4105,2019,2086,4075,30,35,914.13,4.5
"2011","LE2  0","LE2  0","Total",13714,7164,6550,13499,215,104,120.58,113.7
"2011","LE2  1","LE2  1","Total",13444,6950,6494,13096,348,182,202.19,66.5
"2011","LE2  2","LE2  2","Total",7686,3859,3827,5612,2074,185,840.81,9.1
"2011","LE2  3","LE2  3","Total",11456,5521,5935,11068,388,244,268.85,42.6
"2011","LE2  4","LE2  4","Total",12392,6015,6377,12361,31,339,658.54,18.8
"2011","LE2  5","LE2  5","Total",8595,4089,4506,8480,115,154,411.55,20.9
"2011","LE2  6","LE2  6","Total",14815,7136,7679,14773,42,133,352.21,42.1
"2011","LE2  7","LE2  7","Total",10728,5089,5639,7806,2922,139,210.38,51.0
"2011","LE2  8","LE2  8","Total",10833,5343,5490,10558,275,92,349.91,31.0
"2011","LE2  9","LE2  9","Total",15363,7368,7995,15283,80,134,455.41,33.7
"2011","LE3  0","LE3  0","Total",11427,5813,5614,11205,222,147,117.75,97.0
"2011","LE3  1","LE3  1","Total",15585,7458,8127,15438,147,92,362.08,43.0
"2011","LE3  2","LE3  2","Total",14572,7284,7288,14550,22,134,372.08,39.2
"2011","LE3  3","LE3  3","Total",13475,6672,6803,13389,86,180,490.03,27.5
"2011","LE3  5","LE3  5","Total",6329,3327,3002,6284,45,30,94.28,67.1
"2011","LE3  6","LE3  6","Total",12955,6337,6618,12751,204,112,450.45,28.8
"2011","LE3  8","LE3  8","Total",10169,5029,5140,10143,26,122,516.28,19.7
"2011","LE3  9","LE3  9","Total",16401,7906,8495,16313,88,102,381.86,43.0
"2011","LE4  0","LE4  0","Total",15259,7632,7627,15241,18,137,334.32,45.6
"2011","LE4  1","LE4  1","Total",4793,2388,2405,4757,36,57,282.25,17.0
"2011","LE4  2","LE4  2","Total",10402,5046,5356,10263,139,61,516.98,20.1
"2011","LE4  3","LE4  3","Total",5597,2687,2910,5597,0,109,392.93,14.2
"2011","LE4  4","LE4  4","Total",6619,3195,3424,6601,18,78,207.65,31.9
"2011","LE4  5","LE4  5","Total",8951,4356,4595,8813,138,113,162.41,55.1
"2011","LE4  6","LE4  6","Total",15314,7454,7860,15291,23,210,188.41,81.3
"2011","LE4  7","LE4  7","Total",12048,5904,6144,11971,77,191,328.48,36.7
"2011","LE4  8","LE4  8","Total",9668,4768,4900,9609,59,104,466.63,20.7
"2011","LE4  9","LE4  9","Total",8406,4142,4264,8387,19,58,268.83,31.3
"2011","LE5  0","LE5  0","Total",8025,3996,4029,7906,119,43,225.75,35.5
"2011","LE5  1","LE5  1","Total",16743,8104,8639,16699,44,166,385.21,43.5
"2011","LE5  2","LE5  2","Total",10596,5135,5461,10493,103,63,202.88,52.2
"2011","LE5  3","LE5  3","Total",9933,5032,4901,9876,57,56,60.46,164.3
"2011","LE5  4","LE5  4","Total",13782,6921,6861,13688,94,125,240.79,57.2
"2011","LE5  5","LE5  5","Total",17563,8832,8731,17505,58,232,197.66,88.9
"2011","LE5  6","LE5  6","Total",8793,4219,4574,8679,114,168,357.14,24.6
"2011","LE6  0","LE6  0","Total",12073,5871,6202,12073,0,172,3819.15,3.2
"2011","LE65 1","LE65 1","Total",6198,3095,3103,6147,51,123,2502.56,2.5
"2011","LE65 2","LE65 2","Total",7827,3767,4060,7685,142,119,1597.59,4.9
"2011","LE67 1","LE67 1","Total",5471,2712,2759,5460,11,50,2380.64,2.3
"2011","LE67 2","LE67 2","Total",7644,3791,3853,7616,28,104,3069.71,2.5
"2011","LE67 3","LE67 3","Total",8671,4300,4371,8548,123,45,578.89,15.0
"2011","LE67 4","LE67 4","Total",10742,5281,5461,10688,54,91,908.51,11.8
"2011","LE67 5","LE67 5","Total",8486,4153,4333,8460,26,96,641.18,13.2
"2011","LE67 6","LE67 6","Total",5961,2966,2995,5909,52,69,861.27,6.9
"2011","LE67 8","LE67 8","Total",5954,2968,2986,5904,50,78,2210.77,2.7
"2011","LE67 9","LE67 9","Total",5975,2903,3072,5906,69,90,1762.47,3.4
"2011","LE7  1","LE7  1","Total",5695,2777,2918,5653,42,72,482.06,11.8
"2011","LE7  2","LE7  2","Total",7109,3459,3650,7069,40,83,210.05,33.8
"2011","LE7  3","LE7  3","Total",5309,2559,2750,5252,57,84,3439.03,1.5
"2011","LE7  4","LE7  4","Total",4097,2020,2077,3985,112,82,4417.02,0.9
"2011","LE7  7","LE7  7","Total",12499,6048,6451,12451,48,196,1782.01,7.0
"2011","LE7  9","LE7  9","Total",10072,4974,5098,10039,33,272,13921.17,0.7
"2011","LE8  0","LE8  0","Total",6415,3059,3356,6238,177,122,3480.42,1.8
"2011","LE8  4","LE8  4","Total",6194,2980,3214,6160,34,64,492.02,12.6
"2011","LE8  5","LE8  5","Total",6944,3377,3567,6896,48,108,1826.95,3.8
"2011","LE8  6","LE8  6","Total",6893,3333,3560,6845,48,94,1320.55,5.2
"2011","LE8  8","LE8  8","Total",4894,2437,2457,4887,7,72,512.92,9.5
"2011","LE8  9","LE8  9","Total",3673,1756,1917,3673,0,89,3282.13,1.1
"2011","LE9  1","LE9  1","Total",3506,1680,1826,3506,0,63,856.93,4.1
"2011","LE9  2","LE9  2","Total",4667,2206,2461,4570,97,79,715.89,6.5
"2011","LE9  3","LE9  3","Total",3395,1639,1756,3378,17,47,1072.96,3.2
"2011","LE9  4","LE9  4","Total",6345,3116,3229,6295,50,60,1365.45,4.6
"2011","LE9  6","LE9  6","Total",8940,4477,4463,8907,33,131,999.06,8.9
"2011","LE9  7","LE9  7","Total",12081,5961,6120,11985,96,103,4496.61,2.7
"2011","LE9  8","LE9  8","Total",9371,4618,4753,9276,95,74,1164.87,8.0
"2011","LE9  9","LE9  9","Total",6942,3392,3550,6851,91,87,2191.26,3.2
"2011","LN1  1","LN1  1","Total",8526,4158,4368,7514,1012,140,451.25,18.9
"2011","LN1  2","LN1  2","Total",11484,5650,5834,11372,112,179,14527.61,0.8
"2011","LN1  3","LN1  3","Total",8352,3972,4380,8085,267,79,207.99,40.2
"2011","LN10 5","LN10 5","Total",861,416,445,821,40,16,5112.83,0.2
"2011","LN10 6","LN10 6","Total",5124,2473,2651,4988,136,95,3733.41,1.4
"2011","LN11 0","LN11 0","Total",9896,4781,5115,9706,190,137,12787.43,0.8
"2011","LN11 7","LN11 7","Total",5152,2565,2587,5145,7,49,12092.99,0.4
"2011","LN11 8","LN11 8","Total",8144,3945,4199,8081,63,125,11431.19,0.7
"2011","LN11 9","LN11 9","Total",5030,2407,2623,5011,19,82,6197.15,0.8
"2011","LN12 1","LN12 1","Total",5062,2435,2627,4906,156,40,2571.87,2.0
"2011","LN12 2","LN12 2","Total",8159,3880,4279,8000,159,43,1805.13,4.5
"2011","LN13 0","LN13 0","Total",2635,1295,1340,2604,31,41,9983.77,0.3
"2011","LN13 9","LN13 9","Total",5131,2470,2661,5039,92,43,7465.60,0.7
"2011","LN2  1","LN2  1","Total",1860,940,920,1651,209,40,76.19,24.4
"2011","LN2  2","LN2  2","Total",10411,4881,5530,10198,213,150,3385.57,3.1
"2011","LN2  3","LN2  3","Total",6588,3139,3449,6567,21,132,3939.63,1.7
"2011","LN2  4","LN2  4","Total",13180,6537,6643,12606,574,125,701.83,18.8
"2011","LN2  5","LN2  5","Total",6598,3431,3167,6319,279,60,177.21,37.2
"2011","LN3  4","LN3  4","Total",5879,2840,3039,5724,155,56,2371.24,2.5
"2011","LN3  5","LN3  5","Total",3016,1492,1524,2982,34,30,6834.29,0.4
"2011","LN4  1","LN4  1","Total",10558,5114,5444,10479,79,127,4923.98,2.1
"2011","LN4  2","LN4  2","Total",8408,4083,4325,8314,94,150,6513.48,1.3
"2011","LN4  3","LN4  3","Total",8479,4202,4277,8228,251,126,14995.57,0.6
"2011","LN4  4","LN4  4","Total",11213,5719,5494,10607,606,107,13107.39,0.9
"2011","LN5  0","LN5  0","Total",5818,2795,3023,5696,122,103,10815.41,0.5
"2011","LN5  7","LN5  7","Total",5672,2883,2789,5624,48,46,263.35,21.5
"2011","LN5  8","LN5  8","Total",8573,4254,4319,8353,220,63,266.39,32.2
"2011","LN5  9","LN5  9","Total",12124,6018,6106,11641,483,186,6185.09,2.0
"2011","LN6  0","LN6  0","Total",13722,6617,7105,13571,151,93,655.77,20.9
"2011","LN6  3","LN6  3","Total",3931,1922,2009,3892,39,38,160.84,24.4
"2011","LN6  4","LN6  4","Total",270,132,138,270,0,0,43.60,6.2
"2011","LN6  5","LN6  5","Total",3195,1556,1639,3111,84,25,1283.96,2.5
"2011","LN6  7","LN6  7","Total",13978,6732,7246,11219,2759,176,592.00,23.6
"2011","LN6  8","LN6  8","Total",9953,4782,5171,9913,40,101,599.78,16.6
"2011","LN6  9","LN6  9","Total",13300,6500,6800,13116,184,142,8046.78,1.7
"2011","LN7  6","LN7  6","Total",6070,3010,3060,6005,65,125,13869.70,0.4
"2011","LN8  2","LN8  2","Total",1819,906,913,1819,0,32,6524.67,0.3
"2011","LN8  3","LN8  3","Total",9524,4664,4860,9312,212,149,21970.41,0.4
"2011","LN8  5","LN8  5","Total",3090,1497,1593,3045,45,31,10281.58,0.3
"2011","LN8  6","LN8  6","Total",2850,1424,1426,2768,82,36,10088.10,0.3
"2011","LN9  5","LN9  5","Total",4624,2229,2395,4528,96,52,7992.71,0.6
"2011","LN9  6","LN9  6","Total",5051,2462,2589,5024,27,59,9389.79,0.5
"2011","LS1  2","LS1  2","Total",126,71,55,120,6,3,32.10,3.9
"2011","LS1  3","LS1  3","Total",456,260,196,395,61,1,11.40,40.0
"2011","LS1  4","LS1  4","Total",4608,2247,2361,2163,2445,70,73.46,62.7
"2011","LS1  5","LS1  5","Total",205,110,95,205,0,5,2.44,84.0
"2011","LS1  6","LS1  6","Total",364,203,161,364,0,2,19.37,18.8
"2011","LS10 1","LS10 1","Total",4096,2186,1910,3485,611,18,94.09,43.5
"2011","LS10 2","LS10 2","Total",3792,1830,1962,3753,39,10,431.95,8.8
"2011","LS10 3","LS10 3","Total",12752,6144,6608,12676,76,50,442.46,28.8
"2011","LS10 4","LS10 4","Total",14894,7105,7789,14856,38,71,664.17,22.4
"2011","LS11 0","LS11 0","Total",3834,1924,1910,3834,0,20,122.00,31.4
"2011","LS11 5","LS11 5","Total",5164,2579,2585,5147,17,32,232.67,22.2
"2011","LS11 6","LS11 6","Total",6572,3444,3128,6532,40,21,107.55,61.1
"2011","LS11 7","LS11 7","Total",8856,4547,4309,8830,26,45,105.79,83.7
"2011","LS11 8","LS11 8","Total",7659,3798,3861,7581,78,43,261.55,29.3
"2011","LS11 9","LS11 9","Total",2710,1484,1226,2704,6,7,97.42,27.8
"2011","LS12 1","LS12 1","Total",5834,3072,2762,5742,92,17,220.49,26.5
"2011","LS12 2","LS12 2","Total",6042,3279,2763,5546,496,19,193.61,31.2
"2011","LS12 3","LS12 3","Total",8791,4471,4320,8691,100,49,191.65,45.9
"2011","LS12 4","LS12 4","Total",9327,4533,4794,9120,207,50,292.36,31.9
"2011","LS12 5","LS12 5","Total",9423,4487,4936,9395,28,61,627.03,15.0
"2011","LS12 6","LS12 6","Total",1532,774,758,1532,0,9,55.36,27.7
"2011","LS13 1","LS13 1","Total",7356,3664,3692,7348,8,50,364.03,20.2
"2011","LS13 2","LS13 2","Total",10551,5022,5529,10496,55,38,267.80,39.4
"2011","LS13 3","LS13 3","Total",7225,3447,3778,7220,5,40,143.54,50.3
"2011","LS13 4","LS13 4","Total",9889,4855,5034,9884,5,59,228.77,43.2
"2011","LS14 1","LS14 1","Total",7912,3743,4169,7878,34,77,227.54,34.8
"2011","LS14 2","LS14 2","Total",4501,2178,2323,4482,19,20,230.62,19.5
"2011","LS14 3","LS14 3","Total",3179,1535,1644,3179,0,75,1863.41,1.7
"2011","LS14 5","LS14 5","Total",7372,3469,3903,7339,33,29,211.04,34.9
"2011","LS14 6","LS14 6","Total",11520,5509,6011,11453,67,53,359.99,32.0
"2011","LS15 0","LS15 0","Total",7696,3667,4029,7696,0,63,1010.42,7.6
"2011","LS15 4","LS15 4","Total",5195,2500,2695,5187,8,82,2818.10,1.8
"2011","LS15 7","LS15 7","Total",9467,4581,4886,9455,12,97,224.79,42.1
"2011","LS15 8","LS15 8","Total",8739,4190,4549,8703,36,82,814.25,10.7
"2011","LS15 9","LS15 9","Total",3894,1911,1983,3875,19,57,276.41,14.1
"2011","LS16 5","LS16 5","Total",8019,3964,4055,7004,1015,141,308.80,26.0
"2011","LS16 6","LS16 6","Total",9546,4554,4992,9489,57,113,336.15,28.4
"2011","LS16 7","LS16 7","Total",10966,5311,5655,10964,2,176,661.62,16.6
"2011","LS16 8","LS16 8","Total",4114,1962,2152,3732,382,112,1137.92,3.6
"2011","LS16 9","LS16 9","Total",3812,1833,1979,3784,28,94,858.87,4.4
"2011","LS17 0","LS17 0","Total",1389,688,701,1389,0,49,1796.36,0.8
"2011","LS17 5","LS17 5","Total",7154,3478,3676,7144,10,88,223.76,32.0
"2011","LS17 6","LS17 6","Total",10016,4872,5144,9967,49,180,212.60,47.1
"2011","LS17 7","LS17 7","Total",9409,4498,4911,9389,20,221,432.46,21.8
"2011","LS17 8","LS17 8","Total",10909,5203,5706,10879,30,231,667.70,16.3
"2011","LS17 9","LS17 9","Total",4549,2217,2332,4549,0,127,3753.08,1.2
"2011","LS18 4","LS18 4","Total",9326,4451,4875,9272,54,114,287.29,32.5
"2011","LS18 5","LS18 5","Total",9569,4658,4911,9341,228,133,519.29,18.4
"2011","LS19 6","LS19 6","Total",6238,3027,3211,6208,30,112,509.20,12.3
"2011","LS19 7","LS19 7","Total",13597,6573,7024,13492,105,143,1286.66,10.6
"2011","LS2  7","LS2  7","Total",2615,1572,1043,2345,270,13,84.20,31.1
"2011","LS2  8","LS2  8","Total",2261,1075,1186,589,1672,57,31.91,70.9
"2011","LS2  9","LS2  9","Total",5244,2482,2762,3199,2045,81,74.38,70.5
"2011","LS20 8","LS20 8","Total",6947,3427,3520,6947,0,140,1067.01,6.5
"2011","LS20 9","LS20 9","Total",5716,2724,2992,5618,98,60,512.12,11.2
"2011","LS21 1","LS21 1","Total",5753,2833,2920,5703,50,104,1150.41,5.0
"2011","LS21 2","LS21 2","Total",7081,3418,3663,7080,1,110,8586.95,0.8
"2011","LS21 3","LS21 3","Total",4895,2368,2527,4855,40,74,921.71,5.3
"2011","LS22 4","LS22 4","Total",1957,951,1006,1931,26,45,3501.03,0.6
"2011","LS22 5","LS22 5","Total",3765,1949,1816,3565,200,95,3074.07,1.2
"2011","LS22 6","LS22 6","Total",5862,2784,3078,5835,27,118,799.88,7.3
"2011","LS22 7","LS22 7","Total",4207,2023,2184,4156,51,76,127.03,33.1
"2011","LS23 6","LS23 6","Total",7391,3507,3884,7358,33,153,2629.12,2.8
"2011","LS23 7","LS23 7","Total",1816,1299,517,1003,813,24,1272.21,1.4
"2011","LS24 8","LS24 8","Total",3286,1634,1652,3286,0,50,3766.27,0.9
"2011","LS24 9","LS24 9","Total",8563,4174,4389,8523,40,158,8198.57,1.0
"2011","LS25 1","LS25 1","Total",7571,3558,4013,7459,112,76,242.26,31.3
"2011","LS25 2","LS25 2","Total",7396,3591,3805,7385,11,93,684.45,10.8
"2011","LS25 3","LS25 3","Total",1503,735,768,1503,0,23,1797.14,0.8
"2011","LS25 4","LS25 4","Total",1893,955,938,1893,0,8,718.79,2.6
"2011","LS25 5","LS25 5","Total",4693,2297,2396,4681,12,72,4360.93,1.1
"2011","LS25 6","LS25 6","Total",6778,3354,3424,6750,28,90,2254.07,3.0
"2011","LS25 7","LS25 7","Total",10083,4915,5168,10048,35,99,699.39,14.4
"2011","LS26 0","LS26 0","Total",13961,6654,7307,13845,116,112,808.27,17.3
"2011","LS26 8","LS26 8","Total",11914,5821,6093,11892,22,95,927.64,12.8
"2011","LS26 9","LS26 9","Total",4146,2025,2121,4073,73,34,867.15,4.8
"2011","LS27 0","LS27 0","Total",6553,3197,3356,6530,23,32,555.24,11.8
"2011","LS27 7","LS27 7","Total",10556,5128,5428,10515,41,71,842.04,12.5
"2011","LS27 8","LS27 8","Total",9906,4790,5116,9832,74,69,459.17,21.6
"2011","LS27 9","LS27 9","Total",8680,4241,4439,8609,71,61,225.49,38.5
"2011","LS28 5","LS28 5","Total",11426,5486,5940,11347,79,109,828.11,13.8
"2011","LS28 6","LS28 6","Total",3229,1560,1669,3226,3,27,156.16,20.7
"2011","LS28 7","LS28 7","Total",9603,4588,5015,9454,149,70,300.89,31.9
"2011","LS28 8","LS28 8","Total",7539,3588,3951,7446,93,91,339.76,22.2
"2011","LS28 9","LS28 9","Total",6099,2900,3199,6071,28,48,277.59,22.0
"2011","LS29 0","LS29 0","Total",5016,2421,2595,5016,0,133,4435.71,1.1
"2011","LS29 6","LS29 6","Total",5188,2510,2678,5169,19,124,396.44,13.1
"2011","LS29 7","LS29 7","Total",7338,3570,3768,7299,39,194,1298.33,5.7
"2011","LS29 8","LS29 8","Total",8071,3838,4233,7990,81,188,1390.38,5.8
"2011","LS29 9","LS29 9","Total",5843,2711,3132,5570,273,198,251.24,23.3
"2011","LS3  1","LS3  1","Total",2876,1466,1410,2399,477,27,53.35,53.9
"2011","LS4  2","LS4  2","Total",9072,4734,4338,8985,87,47,181.48,50.0
"2011","LS5  3","LS5  3","Total",8507,4243,4264,7488,1019,85,210.30,40.5
"2011","LS6  1","LS6  1","Total",15609,7800,7809,15448,161,142,114.04,136.9
"2011","LS6  2","LS6  2","Total",10943,5320,5623,7985,2958,139,182.76,59.9
"2011","LS6  3","LS6  3","Total",12466,6150,6316,11873,593,151,234.84,53.1
"2011","LS6  4","LS6  4","Total",9259,4533,4726,9198,61,118,260.42,35.6
"2011","LS7  1","LS7  1","Total",3854,2060,1794,3629,225,26,97.66,39.5
"2011","LS7  2","LS7  2","Total",7671,3620,4051,7451,220,70,184.54,41.6
"2011","LS7  3","LS7  3","Total",8642,4166,4476,8597,45,74,161.55,53.5
"2011","LS7  4","LS7  4","Total",8099,3863,4236,8049,50,105,167.04,48.5
"2011","LS8  1","LS8  1","Total",9666,4683,4983,9538,128,237,295.93,32.7
"2011","LS8  2","LS8  2","Total",11990,5853,6137,11743,247,162,556.29,21.6
"2011","LS8  3","LS8  3","Total",12362,6014,6348,12319,43,129,207.83,59.5
"2011","LS8  4","LS8  4","Total",6267,3121,3146,6214,53,79,94.30,66.5
"2011","LS8  5","LS8  5","Total",8001,4074,3927,7993,8,26,77.19,103.7
"2011","LS9  0","LS9  0","Total",6023,2925,3098,6023,0,29,457.41,13.2
"2011","LS9  6","LS9  6","Total",11990,5786,6204,11987,3,68,194.31,61.7
"2011","LS9  7","LS9  7","Total",7352,3974,3378,7302,50,33,129.70,56.7
"2011","LS9  8","LS9  8","Total",5205,2758,2447,4754,451,12,83.37,62.4
"2011","LS9  9","LS9  9","Total",5836,2852,2984,5815,21,22,85.33,68.4
"2011","LU1  1","LU1  1","Total",14292,7736,6556,14158,134,102,205.71,69.5
"2011","LU1  2","LU1  2","Total",1341,753,588,911,430,38,37.68,35.6
"2011","LU1  3","LU1  3","Total",9901,5337,4564,9802,99,102,286.39,34.6
"2011","LU1  4","LU1  4","Total",5534,2696,2838,5527,7,78,1432.02,3.9
"2011","LU1  5","LU1  5","Total",12287,6166,6121,12179,108,106,278.56,44.1
"2011","LU2  0","LU2  0","Total",11628,5929,5699,11588,40,110,257.83,45.1
"2011","LU2  7","LU2  7","Total",20884,10402,10482,20768,116,331,469.12,44.5
"2011","LU2  8","LU2  8","Total",12714,6258,6456,12713,1,173,2005.56,6.3
"2011","LU2  9","LU2  9","Total",11664,5743,5921,11633,31,140,2086.96,5.6
"2011","LU3  1","LU3  1","Total",22499,11315,11184,22331,168,227,246.27,91.4
"2011","LU3  2","LU3  2","Total",13703,6704,6999,13491,212,195,279.21,49.1
"2011","LU3  3","LU3  3","Total",18934,9299,9635,18889,45,199,2690.73,7.0
"2011","LU3  4","LU3  4","Total",5414,2669,2745,5414,0,103,128.07,42.3
"2011","LU4  0","LU4  0","Total",16601,8047,8554,16583,18,160,316.53,52.4
"2011","LU4  8","LU4  8","Total",16444,8413,8031,16430,14,126,205.53,80.0
"2011","LU4  9","LU4  9","Total",19024,9257,9767,18756,268,190,780.29,24.4
"2011","LU5  4","LU5  4","Total",13427,6599,6828,13333,94,153,394.90,34.0
"2011","LU5  5","LU5  5","Total",17363,8527,8836,17257,106,138,1187.35,14.6
"2011","LU5  6","LU5  6","Total",7495,3714,3781,7495,0,143,2429.07,3.1
"2011","LU6  1","LU6  1","Total",10729,5274,5455,10616,113,83,666.56,16.1
"2011","LU6  2","LU6  2","Total",8053,3971,4082,8023,30,180,3975.12,2.0
"2011","LU6  3","LU6  3","Total",12051,5928,6123,12022,29,193,840.94,14.3
"2011","LU7  0","LU7  0","Total",9134,4533,4601,9053,81,199,8548.67,1.1
"2011","LU7  1","LU7  1","Total",5362,2551,2811,5266,96,56,122.33,43.8
"2011","LU7  2","LU7  2","Total",11484,5736,5748,11422,62,222,611.15,18.8
"2011","LU7  3","LU7  3","Total",13198,6529,6669,13096,102,179,530.10,24.9
"2011","LU7  4","LU7  4","Total",7425,3701,3724,7425,0,77,423.46,17.5
"2011","LU7  9","LU7  9","Total",7365,3678,3687,7304,61,142,6780.73,1.1
"2011","M1   1","M1   1","Total",779,441,338,779,0,3,10.69,72.9
"2011","M1   2","M1   2","Total",3438,1884,1554,1973,1465,44,82.03,41.9
"2011","M1   3","M1   3","Total",1074,640,434,1071,3,5,13.28,80.9
"2011","M1   4","M1   4","Total",215,130,85,215,0,1,3.59,59.9
"2011","M1   5","M1   5","Total",3193,1827,1366,2275,918,36,24.78,128.9
"2011","M1   6","M1   6","Total",822,496,326,816,6,6,22.57,36.4
"2011","M1   7","M1   7","Total",2700,1484,1216,1571,1129,32,23.82,113.4
"2011","M11  1","M11  1","Total",5759,2812,2947,5701,58,45,114.89,50.1
"2011","M11  2","M11  2","Total",3173,1605,1568,3173,0,13,195.90,16.2
"2011","M11  3","M11  3","Total",3390,1651,1739,3376,14,14,96.59,35.1
"2011","M11  4","M11  4","Total",8121,3954,4167,8065,56,35,241.54,33.6
"2011","M12  4","M12  4","Total",7173,3657,3516,7151,22,47,147.80,48.5
"2011","M12  5","M12  5","Total",8201,4340,3861,8165,36,53,214.84,38.2
"2011","M12  6","M12  6","Total",802,439,363,736,66,5,37.33,21.5
"2011","M13  0","M13  0","Total",16462,8360,8102,14256,2206,154,157.08,104.8
"2011","M13  9","M13  9","Total",7499,3707,3792,5658,1841,87,157.59,47.6
"2011","M14  4","M14  4","Total",9432,4745,4687,9061,371,44,92.26,102.2
"2011","M14  5","M14  5","Total",10499,5661,4838,8667,1832,105,114.43,91.8
"2011","M14  6","M14  6","Total",19997,9746,10251,16371,3626,217,231.06,86.5
"2011","M14  7","M14  7","Total",12892,6445,6447,12892,0,77,166.04,77.6
"2011","M15  4","M15  4","Total",8271,4701,3570,8271,0,54,108.94,75.9
"2011","M15  5","M15  5","Total",6329,3502,2827,6327,2,41,98.79,64.1
"2011","M15  6","M15  6","Total",7710,3872,3838,3676,4034,92,92.45,83.4
"2011","M16  0","M16  0","Total",7905,3920,3985,7862,43,77,158.57,49.9
"2011","M16  7","M16  7","Total",7628,3666,3962,7593,35,51,123.79,61.6
"2011","M16  8","M16  8","Total",11373,5865,5508,10923,450,94,156.80,72.5
"2011","M16  9","M16  9","Total",8815,4325,4490,8804,11,91,130.68,67.5
"2011","M18  7","M18  7","Total",12643,6191,6452,12624,19,70,258.35,48.9
"2011","M18  8","M18  8","Total",10624,5262,5362,10455,169,69,204.85,51.9
"2011","M19  1","M19  1","Total",11859,5593,6266,11859,0,99,189.11,62.7
"2011","M19  2","M19  2","Total",13048,6538,6510,12992,56,121,209.38,62.3
"2011","M19  3","M19  3","Total",9679,4959,4720,9634,45,57,141.10,68.6
"2011","M20  1","M20  1","Total",7931,3847,4084,7848,83,51,131.48,60.3
"2011","M20  2","M20  2","Total",11380,5746,5634,11020,360,129,311.57,36.5
"2011","M20  3","M20  3","Total",6254,3228,3026,6168,86,76,90.01,69.5
"2011","M20  4","M20  4","Total",10354,5349,5005,10334,20,82,150.01,69.0
"2011","M20  5","M20  5","Total",4595,2283,2312,4589,6,70,159.64,28.8
"2011","M20  6","M20  6","Total",8081,4029,4052,8074,7,111,124.55,64.9
"2011","M21  0","M21  0","Total",6362,3150,3212,6357,5,76,103.20,61.6
"2011","M21  7","M21  7","Total",8308,3949,4359,8306,2,66,311.62,26.7
"2011","M21  8","M21  8","Total",5924,2853,3071,5924,0,70,158.69,37.3
"2011","M21  9","M21  9","Total",8989,4455,4534,8872,117,94,140.60,63.9
"2011","M22  0","M22  0","Total",3171,1548,1623,3171,0,7,109.00,29.1
"2011","M22  1","M22  1","Total",8002,3811,4191,7936,66,29,198.81,40.2
"2011","M22  4","M22  4","Total",10255,5069,5186,10111,144,69,484.92,21.1
"2011","M22  5","M22  5","Total",6491,3126,3365,6490,1,33,271.03,23.9
"2011","M22  8","M22  8","Total",4842,2318,2524,4840,2,18,75.62,64.0
"2011","M22  9","M22  9","Total",9610,4484,5126,9521,89,30,163.34,58.8
"2011","M23  0","M23  0","Total",8758,4261,4497,8689,69,51,166.78,52.5
"2011","M23  1","M23  1","Total",8338,4104,4234,8316,22,42,265.16,31.4
"2011","M23  2","M23  2","Total",5909,2794,3115,5832,77,18,238.45,24.8
"2011","M23  9","M23  9","Total",7944,3850,4094,7925,19,76,179.40,44.3
"2011","M24  1","M24  1","Total",11153,5360,5793,11149,4,143,307.03,36.3
"2011","M24  2","M24  2","Total",13109,6436,6673,12983,126,101,599.39,21.9
"2011","M24  4","M24  4","Total",9177,4516,4661,9128,49,49,636.38,14.4
"2011","M24  5","M24  5","Total",8323,3959,4364,8262,61,65,181.23,45.9
"2011","M24  6","M24  6","Total",4986,2458,2528,4935,51,42,328.91,15.2
"2011","M25  0","M25  0","Total",8978,4444,4534,8881,97,228,134.89,66.6
"2011","M25  1","M25  1","Total",7724,3824,3900,7717,7,83,135.50,57.0
"2011","M25  2","M25  2","Total",3842,1870,1972,3768,74,47,296.19,13.0
"2011","M25  3","M25  3","Total",3268,1569,1699,3208,60,47,107.90,30.3
"2011","M25  9","M25  9","Total",7663,3687,3976,7423,240,104,407.52,18.8
"2011","M26  1","M26  1","Total",10423,5118,5305,10422,1,93,686.12,15.2
"2011","M26  2","M26  2","Total",6112,2999,3113,6102,10,46,251.66,24.3
"2011","M26  3","M26  3","Total",10015,4922,5093,9968,47,97,346.92,28.9
"2011","M26  4","M26  4","Total",8263,4063,4200,8145,118,69,446.66,18.5
"2011","M27  0","M27  0","Total",6983,3397,3586,6983,0,78,209.72,33.3
"2011","M27  4","M27  4","Total",5269,2554,2715,5195,74,43,121.81,43.3
"2011","M27  5","M27  5","Total",8481,4105,4376,8413,68,66,227.23,37.3
"2011","M27  6","M27  6","Total",5647,2725,2922,5621,26,36,229.54,24.6
"2011","M27  8","M27  8","Total",9522,5125,4397,8665,857,35,517.28,18.4
"2011","M27  9","M27  9","Total",6167,3031,3136,6167,0,20,225.40,27.4
"2011","M28  0","M28  0","Total",5697,2745,2952,5688,9,52,147.53,38.6
"2011","M28  1","M28  1","Total",9794,4786,5008,9761,33,135,1106.20,8.9
"2011","M28  2","M28  2","Total",5902,2891,3011,5854,48,89,550.51,10.7
"2011","M28  3","M28  3","Total",10867,5353,5514,10826,41,71,510.59,21.3
"2011","M28  7","M28  7","Total",7165,3467,3698,7162,3,99,229.97,31.2
"2011","M29  7","M29  7","Total",13455,6779,6676,13455,0,156,1738.56,7.7
"2011","M29  8","M29  8","Total",9441,4668,4773,9390,51,74,588.49,16.0
"2011","M3   1","M3   1","Total",734,415,319,524,210,6,45.12,16.3
"2011","M3   2","M3   2","Total",143,80,63,143,0,3,3.19,44.8
"2011","M3   3","M3   3","Total",544,326,218,544,0,1,7.39,73.6
"2011","M3   4","M3   4","Total",2266,1332,934,2265,1,23,57.39,39.5
"2011","M3   5","M3   5","Total",1268,773,495,1232,36,3,30.03,42.2
"2011","M3   6","M3   6","Total",3762,2149,1613,3254,508,46,82.00,45.9
"2011","M3   7","M3   7","Total",2992,1731,1261,2992,0,11,48.89,61.2
"2011","M30  0","M30  0","Total",10099,5087,5012,9871,228,39,220.20,45.9
"2011","M30  7","M30  7","Total",8773,4267,4506,8735,38,47,633.99,13.8
"2011","M30  8","M30  8","Total",9115,4467,4648,9093,22,50,192.34,47.4
"2011","M30  9","M30  9","Total",7996,3987,4009,7931,65,114,182.47,43.8
"2011","M31  4","M31  4","Total",8395,3976,4419,8360,35,50,1202.38,7.0
"2011","M32  0","M32  0","Total",10553,5251,5302,10542,11,96,509.66,20.7
"2011","M32  8","M32  8","Total",6913,3434,3479,6888,25,71,217.97,31.7
"2011","M32  9","M32  9","Total",11120,5384,5736,11100,20,106,304.48,36.5
"2011","M33  2","M33  2","Total",12890,6312,6578,12841,49,144,409.09,31.5
"2011","M33  3","M33  3","Total",12249,6048,6201,12184,65,216,255.36,48.0
"2011","M33  4","M33  4","Total",14234,6973,7261,14188,46,262,366.26,38.9
"2011","M33  5","M33  5","Total",9763,4751,5012,9700,63,140,325.18,30.0
"2011","M33  6","M33  6","Total",6891,3453,3438,6883,8,120,137.26,50.2
"2011","M33  7","M33  7","Total",4447,2208,2239,4443,4,37,136.98,32.5
"2011","M34  2","M34  2","Total",10253,4932,5321,10250,3,86,465.73,22.0
"2011","M34  3","M34  3","Total",8974,4431,4543,8946,28,79,245.34,36.6
"2011","M34  5","M34  5","Total",11739,5729,6010,11631,108,104,448.38,26.2
"2011","M34  6","M34  6","Total",6935,3268,3667,6908,27,53,171.95,40.3
"2011","M34  7","M34  7","Total",8389,4071,4318,8336,53,56,207.38,40.5
"2011","M35  0","M35  0","Total",11288,5420,5868,11191,97,71,270.86,41.7
"2011","M35  9","M35  9","Total",9392,4572,4820,9351,41,79,411.04,22.8
"2011","M38  0","M38  0","Total",2632,1238,1394,2632,0,14,141.48,18.6
"2011","M38  9","M38  9","Total",10326,4964,5362,10265,61,43,241.90,42.7
"2011","M4   1","M4   1","Total",1679,957,722,1668,11,8,35.17,47.7
"2011","M4   4","M4   4","Total",3374,1868,1506,3297,77,17,41.16,82.0
"2011","M4   5","M4   5","Total",1636,923,713,1617,19,14,53.83,30.4
"2011","M4   6","M4   6","Total",1315,769,546,1315,0,1,25.93,50.7
"2011","M4   7","M4   7","Total",2736,1592,1144,2660,76,3,48.90,56.0
"2011","M40  0","M40  0","Total",4260,2037,2223,4168,92,34,111.72,38.1
"2011","M40  1","M40  1","Total",5597,2730,2867,5478,119,31,109.76,51.0
"2011","M40  2","M40  2","Total",5798,2804,2994,5787,11,35,258.21,22.5
"2011","M40  3","M40  3","Total",7424,3561,3863,7350,74,50,166.42,44.6
"2011","M40  5","M40  5","Total",4134,1947,2187,4098,36,31,71.64,57.7
"2011","M40  7","M40  7","Total",5203,2681,2522,5184,19,37,155.20,33.5
"2011","M40  8","M40  8","Total",3862,1996,1866,3819,43,15,103.17,37.4
"2011","M40  9","M40  9","Total",4579,2258,2321,4543,36,28,85.85,53.3
"2011","M41  0","M41  0","Total",5833,2815,3018,5771,62,59,101.75,57.3
"2011","M41  5","M41  5","Total",6517,3233,3284,6396,121,90,154.54,42.2
"2011","M41  6","M41  6","Total",7841,3809,4032,7821,20,80,377.45,20.8
"2011","M41  7","M41  7","Total",5800,2762,3038,5745,55,59,719.76,8.1
"2011","M41  8","M41  8","Total",6522,3185,3337,6522,0,76,231.04,28.2
"2011","M41  9","M41  9","Total",8968,4344,4624,8832,136,88,420.32,21.3
"2011","M43  6","M43  6","Total",9805,4791,5014,9772,33,80,165.94,59.1
"2011","M43  7","M43  7","Total",13450,6495,6955,13406,44,114,380.08,35.4
"2011","M44  5","M44  5","Total",7432,3616,3816,7432,0,38,1265.92,5.9
"2011","M44  6","M44  6","Total",12257,5998,6259,12227,30,81,765.38,16.0
"2011","M45  6","M45  6","Total",5654,2750,2904,5654,0,70,106.53,53.1
"2011","M45  7","M45  7","Total",9439,4535,4904,9353,86,183,683.30,13.8
"2011","M45  8","M45  8","Total",7629,3599,4030,7628,1,68,176.66,43.2
"2011","M46  0","M46  0","Total",10065,5094,4971,10047,18,56,545.66,18.4
"2011","M46  9","M46  9","Total",12138,6054,6084,12002,136,101,391.86,31.0
"2011","M5   3","M5   3","Total",5177,2595,2582,5177,0,17,122.12,42.4
"2011","M5   4","M5   4","Total",5638,2965,2673,5433,205,23,205.95,27.4
"2011","M5   5","M5   5","Total",4914,2386,2528,4883,31,19,210.92,23.3
"2011","M50  1","M50  1","Total",942,487,455,942,0,5,25.15,37.5
"2011","M50  2","M50  2","Total",259,151,108,259,0,0,34.95,7.4
"2011","M50  3","M50  3","Total",2248,1317,931,2248,0,7,95.66,23.5
"2011","M6   5","M6   5","Total",8289,4508,3781,7625,664,51,108.57,76.3
"2011","M6   6","M6   6","Total",5582,2824,2758,4082,1500,78,167.97,33.2
"2011","M6   7","M6   7","Total",9010,4390,4620,8834,176,57,222.96,40.4
"2011","M6   8","M6   8","Total",9093,4435,4658,8927,166,71,192.22,47.3
"2011","M60  7","M60  7","Total",466,213,253,101,365,2,0.34,1370.6
"2011","M60  9","M60  9","Total",971,892,79,168,803,4,20.75,46.8
"2011","M7   1","M7   1","Total",3544,1744,1800,3490,54,4,91.01,38.9
"2011","M7   2","M7   2","Total",5368,2774,2594,5125,243,37,89.48,60.0
"2011","M7   3","M7   3","Total",5256,2538,2718,5219,37,48,187.57,28.0
"2011","M7   4","M7   4","Total",13578,6691,6887,13214,364,435,200.98,67.6
"2011","M8   0","M8   0","Total",10051,5153,4898,9964,87,71,136.40,73.7
"2011","M8   4","M8   4","Total",7702,3947,3755,7682,20,67,443.56,17.4
"2011","M8   5","M8   5","Total",6289,3274,3015,6183,106,39,140.77,44.7
"2011","M8   8","M8   8","Total",3543,1768,1775,3532,11,29,172.40,20.6
"2011","M8   9","M8   9","Total",3513,1763,1750,3509,4,23,39.95,87.9
"2011","M9   0","M9   0","Total",4466,2080,2386,4466,0,19,131.92,33.9
"2011","M9   4","M9   4","Total",8037,3953,4084,8017,20,57,120.94,66.5
"2011","M9   5","M9   5","Total",3775,1896,1879,3665,110,18,154.28,24.5
"2011","M9   6","M9   6","Total",9106,4303,4803,9040,66,39,232.26,39.2
"2011","M9   7","M9   7","Total",6082,3045,3037,6037,45,23,193.06,31.5
"2011","M9   8","M9   8","Total",8052,4005,4047,8045,7,36,208.07,38.7
"2011","ME1  1","ME1  1","Total",5641,2869,2772,5316,325,74,132.93,42.4
"2011","ME1  2","ME1  2","Total",14448,7055,7393,14324,124,152,268.24,53.9
"2011","ME1  3","ME1  3","Total",11103,5669,5434,10163,940,141,1830.07,6.1
"2011","ME10 1","ME10 1","Total",13536,6572,6964,13369,167,132,375.55,36.0
"2011","ME10 2","ME10 2","Total",14571,7140,7431,14479,92,108,672.11,21.7
"2011","ME10 3","ME10 3","Total",7399,3642,3757,7347,52,53,433.59,17.1
"2011","ME10 4","ME10 4","Total",9344,4593,4751,9235,109,97,354.06,26.4
"2011","ME10 5","ME10 5","Total",2732,1356,1376,2732,0,21,99.82,27.4
"2011","ME11 5","ME11 5","Total",3407,1671,1736,3407,0,22,720.59,4.7
"2011","ME12 1","ME12 1","Total",6686,3278,3408,6657,29,28,403.09,16.6
"2011","ME12 2","ME12 2","Total",12721,6223,6498,12577,144,102,547.85,23.2
"2011","ME12 3","ME12 3","Total",11062,5444,5618,10983,79,74,2800.59,3.9
"2011","ME12 4","ME12 4","Total",6415,3828,2587,5119,1296,30,4614.55,1.4
"2011","ME13 0","ME13 0","Total",3508,1740,1768,3492,16,61,8129.33,0.4
"2011","ME13 7","ME13 7","Total",9316,4537,4779,9294,22,84,551.69,16.9
"2011","ME13 8","ME13 8","Total",10000,4759,5241,9857,143,107,564.01,17.7
"2011","ME13 9","ME13 9","Total",5135,2489,2646,5005,130,81,5502.83,0.9
"2011","ME14 1","ME14 1","Total",3247,1912,1335,2586,661,16,64.90,50.0
"2011","ME14 2","ME14 2","Total",10705,5463,5242,10386,319,121,274.71,39.0
"2011","ME14 3","ME14 3","Total",1953,995,958,1948,5,34,2397.24,0.8
"2011","ME14 4","ME14 4","Total",6277,3026,3251,6135,142,186,1499.67,4.2
"2011","ME14 5","ME14 5","Total",9532,4679,4853,9486,46,160,373.58,25.5
"2011","ME15 0","ME15 0","Total",4039,2016,2023,3984,55,77,1989.80,2.0
"2011","ME15 6","ME15 6","Total",10536,5143,5393,10403,133,76,369.35,28.5
"2011","ME15 7","ME15 7","Total",10888,5406,5482,10860,28,95,297.80,36.6
"2011","ME15 8","ME15 8","Total",11055,5325,5730,10930,125,78,655.11,16.9
"2011","ME15 9","ME15 9","Total",11141,5344,5797,11110,31,95,372.31,29.9
"2011","ME16 0","ME16 0","Total",13260,6482,6778,13074,186,188,482.77,27.5
"2011","ME16 8","ME16 8","Total",11475,5630,5845,11105,370,152,261.11,43.9
"2011","ME16 9","ME16 9","Total",5311,2566,2745,5254,57,51,494.83,10.7
"2011","ME17 1","ME17 1","Total",4742,2356,2386,4690,52,67,4898.38,1.0
"2011","ME17 2","ME17 2","Total",3969,1954,2015,3953,16,52,4016.26,1.0
"2011","ME17 3","ME17 3","Total",5728,2815,2913,5465,263,100,3370.17,1.7
"2011","ME17 4","ME17 4","Total",7950,3937,4013,7906,44,103,2073.50,3.8
"2011","ME18 5","ME18 5","Total",4694,2295,2399,4652,42,98,2878.17,1.6
"2011","ME18 6","ME18 6","Total",2109,1032,1077,2104,5,38,1063.05,2.0
"2011","ME19 4","ME19 4","Total",7770,3889,3881,7770,0,96,331.75,23.4
"2011","ME19 5","ME19 5","Total",6360,3113,3247,6350,10,107,3026.94,2.1
"2011","ME19 6","ME19 6","Total",7667,3644,4023,7577,90,103,1116.56,6.9
"2011","ME2  1","ME2  1","Total",5448,2673,2775,5446,2,59,1513.61,3.6
"2011","ME2  2","ME2  2","Total",14407,6971,7436,14396,11,74,374.97,38.4
"2011","ME2  3","ME2  3","Total",12734,6267,6467,12637,97,144,432.20,29.5
"2011","ME2  4","ME2  4","Total",6940,3425,3515,6821,119,63,410.97,16.9
"2011","ME20 6","ME20 6","Total",13367,6581,6786,13330,37,133,788.02,17.0
"2011","ME20 7","ME20 7","Total",7278,3551,3727,7195,83,74,1461.31,5.0
"2011","ME3  0","ME3  0","Total",1648,808,840,1646,2,9,1249.86,1.3
"2011","ME3  7","ME3  7","Total",6309,3108,3201,6292,17,82,3201.53,2.0
"2011","ME3  8","ME3  8","Total",8480,4184,4296,8436,44,105,4051.30,2.1
"2011","ME3  9","ME3  9","Total",9747,4756,4991,9676,71,77,3293.83,3.0
"2011","ME4  3","ME4  3","Total",2847,1483,1364,2847,0,36,68.23,41.7
"2011","ME4  4","ME4  4","Total",3892,2409,1483,2955,937,33,279.86,13.9
"2011","ME4  5","ME4  5","Total",13862,6980,6882,13798,64,79,152.24,91.1
"2011","ME4  6","ME4  6","Total",9590,4732,4858,9407,183,96,223.56,42.9
"2011","ME5  0","ME5  0","Total",11868,5713,6155,11868,0,78,248.99,47.7
"2011","ME5  7","ME5  7","Total",12596,6287,6309,12569,27,98,626.83,20.1
"2011","ME5  8","ME5  8","Total",15253,7524,7729,15253,0,144,285.70,53.4
"2011","ME5  9","ME5  9","Total",11692,5747,5945,11655,37,184,619.24,18.9
"2011","ME6  5","ME6  5","Total",10211,4941,5270,10122,89,64,880.11,11.6
"2011","ME7  1","ME7  1","Total",11550,5834,5716,10919,631,95,144.74,79.8
"2011","ME7  2","ME7  2","Total",12697,6247,6450,12623,74,98,502.46,25.3
"2011","ME7  3","ME7  3","Total",8581,4239,4342,8526,55,154,668.15,12.8
"2011","ME7  4","ME7  4","Total",9682,4922,4760,9554,128,101,115.30,84.0
"2011","ME7  5","ME7  5","Total",9265,4688,4577,9194,71,79,176.94,52.4
"2011","ME8  0","ME8  0","Total",9319,4461,4858,9250,69,129,356.67,26.1
"2011","ME8  6","ME8  6","Total",10031,4815,5216,10031,0,74,184.46,54.4
"2011","ME8  7","ME8  7","Total",7453,3615,3838,7435,18,70,631.92,11.8
"2011","ME8  8","ME8  8","Total",9744,4718,5026,9729,15,84,505.14,19.3
"2011","ME8  9","ME8  9","Total",12667,6228,6439,12632,35,122,232.12,54.6
"2011","ME9  0","ME9  0","Total",2714,1360,1354,2686,28,53,4895.54,0.6
"2011","ME9  7","ME9  7","Total",6826,3303,3523,6754,72,86,4040.74,1.7
"2011","ME9  8","ME9  8","Total",6148,3076,3072,6127,21,61,4445.35,1.4
"2011","ME9  9","ME9  9","Total",4865,2417,2448,4810,55,50,2081.43,2.3
"2011","MK1  1","MK1  1","Total",585,333,252,562,23,7,44.73,13.1
"2011","MK10 7","MK10 7","Total",2513,1258,1255,2507,6,26,206.47,12.2
"2011","MK10 9","MK10 9","Total",11312,5730,5582,11312,0,136,579.60,19.5
"2011","MK11 1","MK11 1","Total",5893,2869,3024,5838,55,80,210.91,27.9
"2011","MK11 2","MK11 2","Total",1843,907,936,1833,10,18,41.69,44.2
"2011","MK12 5","MK12 5","Total",7779,3886,3893,7763,16,74,476.05,16.3
"2011","MK12 6","MK12 6","Total",4713,2262,2451,4713,0,27,196.60,24.0
"2011","MK13 0","MK13 0","Total",4475,2226,2249,4475,0,47,207.75,21.5
"2011","MK13 7","MK13 7","Total",7893,3866,4027,7893,0,70,195.30,40.4
"2011","MK13 8","MK13 8","Total",3466,1838,1628,3457,9,70,115.38,30.0
"2011","MK13 9","MK13 9","Total",3026,1479,1547,3026,0,40,82.63,36.6
"2011","MK14 5","MK14 5","Total",6796,3305,3491,6685,111,132,305.24,22.3
"2011","MK14 6","MK14 6","Total",6047,2897,3150,5997,50,64,467.06,12.9
"2011","MK14 7","MK14 7","Total",5857,2960,2897,5806,51,76,123.98,47.2
"2011","MK15 0","MK15 0","Total",1165,605,560,1135,30,22,259.56,4.5
"2011","MK15 8","MK15 8","Total",1870,891,979,1870,0,31,129.21,14.5
"2011","MK15 9","MK15 9","Total",4170,2026,2144,4155,15,89,213.74,19.5
"2011","MK16 0","MK16 0","Total",5506,2689,2817,5505,1,99,1505.07,3.7
"2011","MK16 8","MK16 8","Total",8088,3861,4227,7919,169,127,2300.87,3.5
"2011","MK16 9","MK16 9","Total",4906,2438,2468,4860,46,88,3954.08,1.2
"2011","MK17 0","MK17 0","Total",6135,3056,3079,6031,104,167,8170.20,0.8
"2011","MK17 8","MK17 8","Total",6685,3272,3413,6587,98,124,2620.72,2.6
"2011","MK17 9","MK17 9","Total",4409,2141,2268,4392,17,84,6935.42,0.6
"2011","MK18 1","MK18 1","Total",9331,4627,4704,8856,475,199,1009.26,9.2
"2011","MK18 2","MK18 2","Total",5993,2973,3020,5993,0,164,6965.33,0.9
"2011","MK18 3","MK18 3","Total",5922,2868,3054,5871,51,149,3830.24,1.5
"2011","MK18 4","MK18 4","Total",3574,1743,1831,3542,32,82,5692.70,0.6
"2011","MK18 5","MK18 5","Total",2284,1255,1029,1657,627,126,5754.96,0.4
"2011","MK18 7","MK18 7","Total",3559,1751,1808,3559,0,78,576.21,6.2
"2011","MK19 6","MK19 6","Total",6489,3229,3260,6488,1,97,3696.43,1.8
"2011","MK19 7","MK19 7","Total",4769,2356,2413,4768,1,77,4501.85,1.1
"2011","MK2  2","MK2  2","Total",6543,3153,3390,6522,21,52,501.27,13.1
"2011","MK2  3","MK2  3","Total",7773,3764,4009,7731,42,65,164.99,47.1
"2011","MK3  5","MK3  5","Total",6492,3153,3339,6433,59,71,447.02,14.5
"2011","MK3  6","MK3  6","Total",5612,2789,2823,5562,50,51,147.15,38.1
"2011","MK3  7","MK3  7","Total",10521,5048,5473,10484,37,129,282.08,37.3
"2011","MK4  1","MK4  1","Total",5719,2789,2930,5719,0,68,148.75,38.4
"2011","MK4  2","MK4  2","Total",5271,2622,2649,5251,20,81,155.18,34.0
"2011","MK4  3","MK4  3","Total",3496,1718,1778,3493,3,54,241.54,14.5
"2011","MK4  4","MK4  4","Total",7381,3875,3506,6971,410,82,290.11,25.4
"2011","MK40 1","MK40 1","Total",3641,1985,1656,3519,122,29,69.66,52.3
"2011","MK40 2","MK40 2","Total",7278,3804,3474,6079,1199,104,290.68,25.0
"2011","MK40 3","MK40 3","Total",8351,4107,4244,8058,293,154,150.57,55.5
"2011","MK40 4","MK40 4","Total",11739,5865,5874,11713,26,233,716.11,16.4
"2011","MK41 0","MK41 0","Total",9535,4529,5006,9502,33,115,1264.37,7.5
"2011","MK41 6","MK41 6","Total",4560,2161,2399,4381,179,55,839.34,5.4
"2011","MK41 7","MK41 7","Total",12153,6023,6130,12061,92,172,387.69,31.3
"2011","MK41 8","MK41 8","Total",7932,3867,4065,7908,24,149,249.93,31.7
"2011","MK41 9","MK41 9","Total",8357,4001,4356,7861,496,133,229.92,36.3
"2011","MK42 0","MK42 0","Total",12215,5902,6313,12165,50,77,546.05,22.4
"2011","MK42 6","MK42 6","Total",976,458,518,947,29,10,272.51,3.6
"2011","MK42 7","MK42 7","Total",8460,4083,4377,8424,36,86,677.09,12.5
"2011","MK42 8","MK42 8","Total",10425,5074,5351,10330,95,115,237.34,43.9
"2011","MK42 9","MK42 9","Total",12482,6135,6347,12471,11,116,823.75,15.2
"2011","MK43 0","MK43 0","Total",12222,6302,5920,11603,619,161,6021.77,2.0
"2011","MK43 7","MK43 7","Total",7357,3608,3749,7313,44,163,5995.72,1.2
"2011","MK43 8","MK43 8","Total",7180,3530,3650,7142,38,186,4879.38,1.5
"2011","MK43 9","MK43 9","Total",6224,3084,3140,6223,1,89,2225.74,2.8
"2011","MK44 1","MK44 1","Total",5230,2536,2694,5154,76,175,6813.50,0.8
"2011","MK44 2","MK44 2","Total",3473,1717,1756,3452,21,90,8541.57,0.4
"2011","MK44 3","MK44 3","Total",6614,3249,3365,6577,37,118,7190.56,0.9
"2011","MK45 1","MK45 1","Total",12664,6352,6312,12626,38,224,842.49,15.0
"2011","MK45 2","MK45 2","Total",10307,5049,5258,10275,32,221,2548.88,4.0
"2011","MK45 3","MK45 3","Total",5845,2855,2990,5845,0,84,4229.70,1.4
"2011","MK45 4","MK45 4","Total",9116,4474,4642,9079,37,199,3601.24,2.5
"2011","MK45 5","MK45 5","Total",5117,2592,2525,5080,37,102,2538.71,2.0
"2011","MK46 4","MK46 4","Total",3081,1468,1613,3042,39,55,1477.26,2.1
"2011","MK46 5","MK46 5","Total",6045,2955,3090,5985,60,148,4792.93,1.3
"2011","MK5  6","MK5  6","Total",5255,2599,2656,5248,7,103,202.61,25.9
"2011","MK5  7","MK5  7","Total",6906,3351,3555,6877,29,152,171.59,40.2
"2011","MK5  8","MK5  8","Total",3277,1560,1717,3258,19,79,264.35,12.4
"2011","MK6  2","MK6  2","Total",10880,5706,5174,10855,25,105,201.94,53.9
"2011","MK6  3","MK6  3","Total",5567,2798,2769,5538,29,69,349.26,15.9
"2011","MK6  4","MK6  4","Total",6155,3015,3140,6070,85,35,277.58,22.2
"2011","MK6  5","MK6  5","Total",5511,2689,2822,5357,154,38,164.88,33.4
"2011","MK7  6","MK7  6","Total",2636,1238,1398,2478,158,44,152.06,17.3
"2011","MK7  7","MK7  7","Total",6939,3445,3494,6939,0,100,311.93,22.2
"2011","MK7  8","MK7  8","Total",4984,2471,2513,4976,8,87,249.31,20.0
"2011","MK8  0","MK8  0","Total",4761,2352,2409,4653,108,74,389.27,12.2
"2011","MK8  8","MK8  8","Total",4215,2104,2111,4215,0,78,286.68,14.7
"2011","MK8  9","MK8  9","Total",3086,1545,1541,3029,57,75,64.29,48.0
"2011","MK9  2","MK9  2","Total",1416,831,585,1414,2,8,116.89,12.1
"2011","MK9  3","MK9  3","Total",1548,894,654,1547,1,15,156.31,9.9
"2011","MK9  4","MK9  4","Total",402,225,177,402,0,2,7.58,53.0
"2011","N1   0","N1   0","Total",10637,5123,5514,10427,210,104,79.00,134.6
"2011","N1   1","N1   1","Total",8827,4374,4453,8827,0,110,60.00,147.1
"2011","N1   2","N1   2","Total",11521,5492,6029,11513,8,114,86.49,133.2
"2011","N1   3","N1   3","Total",8041,3873,4168,8041,0,45,49.89,161.2
"2011","N1   4","N1   4","Total",8767,4303,4464,8631,136,56,63.41,138.3
"2011","N1   5","N1   5","Total",9305,4709,4596,9271,34,80,62.98,147.7
"2011","N1   6","N1   6","Total",8465,4222,4243,7750,715,90,44.96,188.3
"2011","N1   7","N1   7","Total",11223,5763,5460,11181,42,122,66.05,169.9
"2011","N1   8","N1   8","Total",7709,3860,3849,7542,167,80,49.89,154.5
"2011","N1   9","N1   9","Total",6561,3246,3315,6093,468,52,49.50,132.5
"2011","N10  1","N10  1","Total",8657,4140,4517,8616,41,126,147.85,58.6
"2011","N10  2","N10  2","Total",9844,4819,5025,9777,67,186,195.78,50.3
"2011","N10  3","N10  3","Total",9491,4562,4929,9355,136,234,141.68,67.0
"2011","N11  1","N11  1","Total",9710,4751,4959,9536,174,101,203.89,47.6
"2011","N11  2","N11  2","Total",10723,5363,5360,10703,20,96,130.26,82.3
"2011","N11  3","N11  3","Total",9446,4724,4722,9241,205,106,139.52,67.7
"2011","N12  0","N12  0","Total",8407,4140,4267,8333,74,142,144.17,58.3
"2011","N12  7","N12  7","Total",5717,2747,2970,5624,93,113,132.69,43.1
"2011","N12  8","N12  8","Total",7771,3718,4053,7610,161,82,96.67,80.4
"2011","N12  9","N12  9","Total",7003,3416,3587,6892,111,116,92.85,75.4
"2011","N13  4","N13  4","Total",12771,6354,6417,12561,210,206,185.10,69.0
"2011","N13  5","N13  5","Total",12979,6305,6674,12919,60,143,162.22,80.0
"2011","N13  6","N13  6","Total",6033,2925,3108,6033,0,58,79.18,76.2
"2011","N14  4","N14  4","Total",10824,5112,5712,10708,116,132,235.66,45.9
"2011","N14  5","N14  5","Total",6217,2996,3221,6133,84,103,106.17,58.6
"2011","N14  6","N14  6","Total",7009,3397,3612,6988,21,111,142.45,49.2
"2011","N14  7","N14  7","Total",5906,2900,3006,5863,43,121,113.06,52.2
"2011","N15  3","N15  3","Total",10606,5490,5116,10497,109,65,87.59,121.1
"2011","N15  4","N15  4","Total",10314,5067,5247,10118,196,91,108.14,95.4
"2011","N15  5","N15  5","Total",9828,4989,4839,9788,40,80,70.38,139.6
"2011","N15  6","N15  6","Total",12970,6536,6434,12957,13,151,99.23,130.7
"2011","N16  0","N16  0","Total",8675,4123,4552,8625,50,85,81.67,106.2
"2011","N16  5","N16  5","Total",15922,7859,8063,15832,90,187,124.98,127.4
"2011","N16  6","N16  6","Total",15262,7562,7700,15239,23,233,92.95,164.2
"2011","N16  7","N16  7","Total",11143,5548,5595,11107,36,81,65.83,169.3
"2011","N16  8","N16  8","Total",11466,5579,5887,11434,32,63,61.79,185.6
"2011","N16  9","N16  9","Total",6099,3008,3091,6066,33,61,36.13,168.8
"2011","N17  0","N17  0","Total",10984,5514,5470,10857,127,93,177.06,62.0
"2011","N17  6","N17  6","Total",20703,10353,10350,20552,151,184,175.57,117.9
"2011","N17  7","N17  7","Total",10251,4746,5505,10251,0,93,129.63,79.1
"2011","N17  8","N17  8","Total",8006,3818,4188,7978,28,56,72.19,110.9
"2011","N17  9","N17  9","Total",13594,6747,6847,13559,35,129,164.45,82.7
"2011","N18  1","N18  1","Total",15726,7490,8236,15643,83,184,185.23,84.9
"2011","N18  2","N18  2","Total",16016,7671,8345,15936,80,145,356.60,44.9
"2011","N19  3","N19  3","Total",12727,6099,6628,12653,74,149,86.43,147.3
"2011","N19  4","N19  4","Total",10590,5072,5518,10586,4,100,75.74,139.8
"2011","N19  5","N19  5","Total",10435,4995,5440,10414,21,82,81.20,128.5
"2011","N2   0","N2   0","Total",10187,4785,5402,10004,183,210,273.43,37.3
"2011","N2   8","N2   8","Total",6122,2929,3193,6122,0,50,57.19,107.0
"2011","N2   9","N2   9","Total",7659,3786,3873,7651,8,142,185.56,41.3
"2011","N20  0","N20  0","Total",10831,5183,5648,10772,59,153,224.28,48.3
"2011","N20  8","N20  8","Total",4217,2040,2177,4214,3,168,639.35,6.6
"2011","N20  9","N20  9","Total",3976,1906,2070,3875,101,109,116.19,34.2
"2011","N21  1","N21  1","Total",8710,4262,4448,8632,78,136,197.40,44.1
"2011","N21  2","N21  2","Total",6976,3466,3510,6939,37,141,192.60,36.2
"2011","N21  3","N21  3","Total",7814,3913,3901,7712,102,103,201.40,38.8
"2011","N22  5","N22  5","Total",13898,6920,6978,13882,16,106,134.71,103.2
"2011","N22  6","N22  6","Total",12558,6069,6489,12423,135,109,101.73,123.4
"2011","N22  7","N22  7","Total",7164,3481,3683,7157,7,99,129.41,55.4
"2011","N22  8","N22  8","Total",9231,4584,4647,9193,38,66,64.63,142.8
"2011","N3   1","N3   1","Total",9294,4488,4806,9224,70,158,139.47,66.6
"2011","N3   2","N3   2","Total",9303,4551,4752,9236,67,110,127.34,73.1
"2011","N3   3","N3   3","Total",7937,3838,4099,7859,78,201,138.85,57.2
"2011","N4   1","N4   1","Total",12671,6469,6202,12601,70,102,97.56,129.9
"2011","N4   2","N4   2","Total",15947,8091,7856,15821,126,111,170.83,93.4
"2011","N4   3","N4   3","Total",11549,5729,5820,11473,76,59,80.16,144.1
"2011","N4   4","N4   4","Total",7124,3512,3612,7124,0,79,64.43,110.6
"2011","N5   1","N5   1","Total",12004,5929,6075,12004,0,124,96.58,124.3
"2011","N5   2","N5   2","Total",12283,5990,6293,12093,190,164,85.71,143.3
"2011","N6   4","N6   4","Total",5160,2481,2679,5084,76,117,152.93,33.7
"2011","N6   5","N6   5","Total",10978,5555,5423,10761,217,154,178.52,61.5
"2011","N6   6","N6   6","Total",3336,1544,1792,3328,8,76,186.93,17.8
"2011","N7   0","N7   0","Total",13129,6381,6748,12369,760,149,87.70,149.7
"2011","N7   6","N7   6","Total",6788,3439,3349,6788,0,48,46.80,145.0
"2011","N7   7","N7   7","Total",7154,3561,3593,6977,177,59,46.56,153.7
"2011","N7   8","N7   8","Total",11553,5933,5620,10951,602,77,73.63,156.9
"2011","N7   9","N7   9","Total",9533,4595,4938,9268,265,69,82.12,116.1
"2011","N8   0","N8   0","Total",11252,5729,5523,11225,27,73,103.74,108.5
"2011","N8   7","N8   7","Total",9873,4792,5081,9865,8,108,86.07,114.7
"2011","N8   8","N8   8","Total",8604,4277,4327,8439,165,133,93.33,92.2
"2011","N8   9","N8   9","Total",10308,4994,5314,10299,9,129,95.82,107.6
"2011","N9   0","N9   0","Total",12205,5752,6453,12205,0,110,108.85,112.1
"2011","N9   7","N9   7","Total",10129,4887,5242,10030,99,107,130.19,77.8
"2011","N9   8","N9   8","Total",12656,6086,6570,12629,27,128,267.10,47.4
"2011","N9   9","N9   9","Total",17203,8213,8990,17166,37,200,230.07,74.8
"2011","NE1  2","NE1  2","Total",3077,1684,1393,2296,781,32,45.97,66.9
"2011","NE1  3","NE1  3","Total",621,381,240,621,0,6,26.01,23.9
"2011","NE1  4","NE1  4","Total",1966,1148,818,1625,341,19,81.50,24.1
"2011","NE1  5","NE1  5","Total",1053,664,389,935,118,8,25.76,40.9
"2011","NE1  6","NE1  6","Total",1341,718,623,714,627,31,33.76,39.7
"2011","NE1  8","NE1  8","Total",993,574,419,421,572,29,25.58,38.8
"2011","NE10 0","NE10 0","Total",8892,4366,4526,8833,59,47,433.47,20.5
"2011","NE10 8","NE10 8","Total",17836,8647,9189,17836,0,83,657.01,27.1
"2011","NE10 9","NE10 9","Total",9493,4545,4948,9400,93,35,225.28,42.1
"2011","NE11 0","NE11 0","Total",4185,2027,2158,4146,39,22,2092.37,2.0
"2011","NE11 9","NE11 9","Total",12274,5951,6323,12238,36,64,442.88,27.7
"2011","NE12 5","NE12 5","Total",1914,934,980,1909,5,1,54.15,35.3
"2011","NE12 6","NE12 6","Total",8685,4222,4463,8685,0,55,362.18,24.0
"2011","NE12 7","NE12 7","Total",5005,2376,2629,4977,28,24,267.75,18.7
"2011","NE12 8","NE12 8","Total",9991,4806,5185,9938,53,72,294.53,33.9
"2011","NE12 9","NE12 9","Total",9501,4565,4936,9348,153,76,523.78,18.1
"2011","NE13 6","NE13 6","Total",5547,2603,2944,5502,45,52,2881.75,1.9
"2011","NE13 7","NE13 7","Total",5294,2532,2762,5272,22,44,1715.27,3.1
"2011","NE13 8","NE13 8","Total",1069,512,557,1069,0,22,733.77,1.5
"2011","NE13 9","NE13 9","Total",941,479,462,941,0,4,385.40,2.4
"2011","NE15 0","NE15 0","Total",2347,1232,1115,2181,166,35,3520.28,0.7
"2011","NE15 6","NE15 6","Total",5961,2858,3103,5891,70,27,242.42,24.6
"2011","NE15 7","NE15 7","Total",9328,4545,4783,9268,60,50,335.54,27.8
"2011","NE15 8","NE15 8","Total",8829,4262,4567,8776,53,31,575.05,15.4
"2011","NE15 9","NE15 9","Total",6226,3020,3206,6136,90,25,526.80,11.8
"2011","NE16 3","NE16 3","Total",3335,1648,1687,3276,59,22,209.54,15.9
"2011","NE16 4","NE16 4","Total",6424,3148,3276,6346,78,58,305.53,21.0
"2011","NE16 5","NE16 5","Total",10913,5294,5619,10908,5,117,1565.97,7.0
"2011","NE16 6","NE16 6","Total",5002,2477,2525,4941,61,51,965.65,5.2
"2011","NE17 7","NE17 7","Total",4669,2303,2366,4622,47,46,605.34,7.7
"2011","NE18 0","NE18 0","Total",927,447,480,924,3,19,3993.16,0.2
"2011","NE19 1","NE19 1","Total",1240,634,606,1219,21,26,28568.68,0.0
"2011","NE19 2","NE19 2","Total",1033,498,535,1033,0,34,13323.20,0.1
"2011","NE2  1","NE2  1","Total",9878,5129,4749,8620,1258,109,153.55,64.3
"2011","NE2  2","NE2  2","Total",7321,3866,3455,7169,152,127,93.87,78.0
"2011","NE2  3","NE2  3","Total",7198,3774,3424,7145,53,102,106.37,67.7
"2011","NE2  4","NE2  4","Total",5132,2645,2487,3670,1462,100,273.14,18.8
"2011","NE20 0","NE20 0","Total",1426,704,722,1353,73,31,11081.51,0.1
"2011","NE20 9","NE20 9","Total",10447,5070,5377,10388,59,246,2803.78,3.7
"2011","NE21 4","NE21 4","Total",5620,2670,2950,5526,94,24,264.39,21.3
"2011","NE21 5","NE21 5","Total",5350,2587,2763,5330,20,29,379.98,14.1
"2011","NE21 6","NE21 6","Total",6306,3054,3252,6260,46,47,793.44,7.9
"2011","NE22 5","NE22 5","Total",8937,4312,4625,8872,65,46,620.84,14.4
"2011","NE22 6","NE22 6","Total",5657,2751,2906,5652,5,59,932.75,6.1
"2011","NE22 7","NE22 7","Total",3290,1610,1680,3174,116,29,377.47,8.7
"2011","NE23 1","NE23 1","Total",3745,1796,1949,3604,141,31,363.82,10.3
"2011","NE23 2","NE23 2","Total",5826,2767,3059,5826,0,42,131.95,44.2
"2011","NE23 3","NE23 3","Total",5710,2799,2911,5710,0,82,409.97,13.9
"2011","NE23 6","NE23 6","Total",10745,5128,5617,10597,148,68,428.43,25.1
"2011","NE23 7","NE23 7","Total",10580,5138,5442,10526,54,55,1069.34,9.9
"2011","NE23 8","NE23 8","Total",2627,1285,1342,2583,44,15,892.58,2.9
"2011","NE24 1","NE24 1","Total",3565,1714,1851,3532,33,19,416.00,8.6
"2011","NE24 2","NE24 2","Total",6252,3036,3216,6122,130,29,113.80,54.9
"2011","NE24 3","NE24 3","Total",11064,5460,5604,11064,0,70,426.35,26.0
"2011","NE24 4","NE24 4","Total",7700,3766,3934,7607,93,36,1037.93,7.4
"2011","NE24 5","NE24 5","Total",9495,4561,4934,9375,120,30,271.71,34.9
"2011","NE25 0","NE25 0","Total",9350,4562,4788,9306,44,38,1494.61,6.3
"2011","NE25 8","NE25 8","Total",9169,4388,4781,9132,37,115,209.68,43.7
"2011","NE25 9","NE25 9","Total",11289,5413,5876,11183,106,143,374.93,30.1
"2011","NE26 1","NE26 1","Total",5264,2601,2663,5133,131,73,104.09,50.6
"2011","NE26 2","NE26 2","Total",4523,2274,2249,4339,184,54,66.96,67.5
"2011","NE26 3","NE26 3","Total",5275,2535,2740,5265,10,108,328.29,16.1
"2011","NE26 4","NE26 4","Total",4264,2040,2224,4236,28,44,983.29,4.3
"2011","NE27 0","NE27 0","Total",12024,5751,6273,11981,43,65,1117.08,10.8
"2011","NE28 0","NE28 0","Total",8701,4154,4547,8586,115,32,243.03,35.8
"2011","NE28 6","NE28 6","Total",5201,2600,2601,5159,42,18,248.47,20.9
"2011","NE28 7","NE28 7","Total",8007,3928,4079,7936,71,38,222.91,35.9
"2011","NE28 8","NE28 8","Total",9635,4671,4964,9634,1,42,278.95,34.5
"2011","NE28 9","NE28 9","Total",13205,6273,6932,13150,55,71,414.53,31.9
"2011","NE29 0","NE29 0","Total",6582,3152,3430,6408,174,42,114.66,57.4
"2011","NE29 6","NE29 6","Total",7712,3976,3736,7641,71,21,310.66,24.8
"2011","NE29 7","NE29 7","Total",8361,3950,4411,8356,5,36,243.12,34.4
"2011","NE29 8","NE29 8","Total",8812,4206,4606,8812,0,54,412.64,21.4
"2011","NE29 9","NE29 9","Total",4146,1993,2153,4020,126,42,105.20,39.4
"2011","NE3  1","NE3  1","Total",9084,4518,4566,8836,248,184,196.27,46.3
"2011","NE3  2","NE3  2","Total",13842,6790,7052,13774,68,139,376.65,36.8
"2011","NE3  3","NE3  3","Total",11578,5632,5946,11402,176,94,272.12,42.5
"2011","NE3  4","NE3  4","Total",10550,5166,5384,10411,139,237,285.58,36.9
"2011","NE3  5","NE3  5","Total",7996,3869,4127,7916,80,148,691.76,11.6
"2011","NE30 1","NE30 1","Total",1317,635,682,1317,0,2,33.92,38.8
"2011","NE30 2","NE30 2","Total",7761,3721,4040,7676,85,99,197.70,39.3
"2011","NE30 3","NE30 3","Total",8303,3961,4342,8303,0,96,178.23,46.6
"2011","NE30 4","NE30 4","Total",4952,2409,2543,4887,65,46,143.98,34.4
"2011","NE31 1","NE31 1","Total",10260,4982,5278,10128,132,43,332.80,30.8
"2011","NE31 2","NE31 2","Total",9870,4723,5147,9771,99,44,308.52,32.0
"2011","NE32 3","NE32 3","Total",5327,2552,2775,5180,147,22,367.95,14.5
"2011","NE32 4","NE32 4","Total",10419,5012,5407,10411,8,42,300.85,34.6
"2011","NE32 5","NE32 5","Total",9643,4693,4950,9541,102,61,291.21,33.1
"2011","NE33 1","NE33 1","Total",1316,672,644,1314,2,6,98.54,13.4
"2011","NE33 2","NE33 2","Total",6229,3095,3134,6041,188,49,143.27,43.5
"2011","NE33 3","NE33 3","Total",7866,3929,3937,7565,301,49,151.08,52.1
"2011","NE33 4","NE33 4","Total",7324,3682,3642,7234,90,30,126.41,57.9
"2011","NE33 5","NE33 5","Total",4334,2300,2034,4314,20,23,135.28,32.0
"2011","NE34 0","NE34 0","Total",10653,5102,5551,10510,143,49,220.43,48.3
"2011","NE34 6","NE34 6","Total",9264,4392,4872,9248,16,70,189.33,48.9
"2011","NE34 7","NE34 7","Total",11667,5483,6184,11566,101,50,283.33,41.2
"2011","NE34 8","NE34 8","Total",10126,4857,5269,10084,42,54,288.40,35.1
"2011","NE34 9","NE34 9","Total",10769,5041,5728,10762,7,43,274.14,39.3
"2011","NE35 9","NE35 9","Total",6428,3152,3276,6428,0,41,270.91,23.7
"2011","NE36 0","NE36 0","Total",6854,3249,3605,6854,0,71,1579.01,4.3
"2011","NE37 1","NE37 1","Total",9759,4743,5016,9696,63,48,370.93,26.3
"2011","NE37 2","NE37 2","Total",7202,3355,3847,7146,56,38,205.54,35.0
"2011","NE37 3","NE37 3","Total",4095,2076,2019,4095,0,16,953.41,4.3
"2011","NE38 0","NE38 0","Total",9145,4523,4622,9140,5,53,282.20,32.4
"2011","NE38 7","NE38 7","Total",9000,4379,4621,8988,12,48,287.82,31.3
"2011","NE38 8","NE38 8","Total",7820,3800,4020,7783,37,68,574.01,13.6
"2011","NE38 9","NE38 9","Total",5136,2512,2624,5134,2,62,233.11,22.0
"2011","NE39 1","NE39 1","Total",3968,1914,2054,3965,3,51,338.68,11.7
"2011","NE39 2","NE39 2","Total",4607,2181,2426,4541,66,45,1606.06,2.9
"2011","NE4  5","NE4  5","Total",7963,4324,3639,7950,13,55,95.79,83.1
"2011","NE4  6","NE4  6","Total",7247,3917,3330,6782,465,59,184.74,39.2
"2011","NE4  7","NE4  7","Total",2452,1333,1119,2452,0,17,88.91,27.6
"2011","NE4  8","NE4  8","Total",7753,4049,3704,7714,39,43,109.92,70.5
"2011","NE4  9","NE4  9","Total",12022,5960,6062,11613,409,154,229.66,52.3
"2011","NE40 3","NE40 3","Total",7629,3650,3979,7596,33,90,446.71,17.1
"2011","NE40 4","NE40 4","Total",8006,3845,4161,7906,100,59,853.22,9.4
"2011","NE41 8","NE41 8","Total",2197,1065,1132,2164,33,52,1038.73,2.1
"2011","NE42 5","NE42 5","Total",6974,3379,3595,6894,80,56,741.11,9.4
"2011","NE42 6","NE42 6","Total",5633,2689,2944,5585,48,90,765.34,7.4
"2011","NE43 7","NE43 7","Total",4523,2197,2326,4415,108,117,5639.75,0.8
"2011","NE44 6","NE44 6","Total",966,448,518,925,41,25,756.80,1.3
"2011","NE45 5","NE45 5","Total",3672,1743,1929,3556,116,89,4149.37,0.9
"2011","NE46 1","NE46 1","Total",4198,1961,2237,3939,259,73,2652.64,1.6
"2011","NE46 2","NE46 2","Total",4459,2113,2346,4375,84,127,1665.37,2.7
"2011","NE46 3","NE46 3","Total",3510,1687,1823,3494,16,92,170.86,20.5
"2011","NE46 4","NE46 4","Total",3370,1696,1674,3311,59,77,10736.18,0.3
"2011","NE47 0","NE47 0","Total",1070,539,531,1030,40,24,10197.91,0.1
"2011","NE47 5","NE47 5","Total",906,452,454,906,0,11,2390.42,0.4
"2011","NE47 6","NE47 6","Total",2184,1076,1108,2154,30,52,7129.36,0.3
"2011","NE47 7","NE47 7","Total",1214,609,605,1158,56,34,8680.70,0.1
"2011","NE47 8","NE47 8","Total",522,264,258,492,30,13,11382.06,0.0
"2011","NE47 9","NE47 9","Total",2021,996,1025,2007,14,50,10853.55,0.2
"2011","NE48 1","NE48 1","Total",764,383,381,764,0,24,43683.76,0.0
"2011","NE48 2","NE48 2","Total",1852,921,931,1850,2,30,10349.24,0.2
"2011","NE48 3","NE48 3","Total",1105,557,548,1105,0,17,17262.58,0.1
"2011","NE48 4","NE48 4","Total",573,275,298,573,0,30,2019.20,0.3
"2011","NE49 0","NE49 0","Total",1085,526,559,1079,6,18,6063.40,0.2
"2011","NE49 9","NE49 9","Total",3259,1606,1653,3250,9,38,1224.45,2.7
"2011","NE5  1","NE5  1","Total",8712,4182,4530,8675,37,73,1068.22,8.2
"2011","NE5  2","NE5  2","Total",14247,6843,7404,14242,5,64,318.78,44.7
"2011","NE5  3","NE5  3","Total",10188,4992,5196,10059,129,38,244.52,41.7
"2011","NE5  4","NE5  4","Total",8841,4218,4623,8730,111,36,251.45,35.2
"2011","NE5  5","NE5  5","Total",7115,3317,3798,6988,127,35,139.98,50.8
"2011","NE6  1","NE6  1","Total",3214,1689,1525,3180,34,6,105.42,30.5
"2011","NE6  2","NE6  2","Total",11558,5621,5937,11397,161,30,221.17,52.3
"2011","NE6  3","NE6  3","Total",8348,4131,4217,8179,169,35,233.99,35.7
"2011","NE6  4","NE6  4","Total",11940,5879,6061,11903,37,62,302.36,39.5
"2011","NE6  5","NE6  5","Total",15967,8405,7562,15794,173,133,198.01,80.6
"2011","NE61 1","NE61 1","Total",4134,1988,2146,3738,396,65,408.76,10.1
"2011","NE61 2","NE61 2","Total",8928,4299,4629,8879,49,170,525.01,17.0
"2011","NE61 3","NE61 3","Total",3853,1908,1945,3853,0,95,13467.36,0.3
"2011","NE61 4","NE61 4","Total",1260,628,632,1244,16,30,19712.21,0.1
"2011","NE61 5","NE61 5","Total",8080,3999,4081,8014,66,86,4335.07,1.9
"2011","NE61 6","NE61 6","Total",5014,2469,2545,4967,47,66,3145.48,1.6
"2011","NE62 5","NE62 5","Total",9636,4623,5013,9542,94,66,1167.39,8.3
"2011","NE63 0","NE63 0","Total",8147,3989,4158,8136,11,46,264.20,30.8
"2011","NE63 8","NE63 8","Total",8490,4140,4350,8385,105,102,1361.93,6.2
"2011","NE63 9","NE63 9","Total",11152,5477,5675,11052,100,56,732.73,15.2
"2011","NE64 6","NE64 6","Total",6308,3034,3274,6242,66,30,864.92,7.3
"2011","NE65 0","NE65 0","Total",7878,3833,4045,7808,70,89,2988.23,2.6
"2011","NE65 7","NE65 7","Total",3889,1914,1975,3861,28,69,39117.78,0.1
"2011","NE65 8","NE65 8","Total",2141,1024,1117,2138,3,53,6657.34,0.3
"2011","NE65 9","NE65 9","Total",6856,3849,3007,5741,1115,82,10528.29,0.7
"2011","NE66 1","NE66 1","Total",6766,3206,3560,6664,102,81,1744.83,3.9
"2011","NE66 2","NE66 2","Total",4244,2074,2170,4093,151,62,15568.13,0.3
"2011","NE66 3","NE66 3","Total",4720,2359,2361,4463,257,74,9787.08,0.5
"2011","NE66 4","NE66 4","Total",1522,748,774,1522,0,36,22890.00,0.1
"2011","NE66 5","NE66 5","Total",338,168,170,337,1,11,4675.87,0.1
"2011","NE67 5","NE67 5","Total",834,423,411,831,3,25,4986.69,0.2
"2011","NE68 7","NE68 7","Total",1959,953,1006,1952,7,16,790.33,2.5
"2011","NE69 7","NE69 7","Total",414,196,218,411,3,5,1445.21,0.3
"2011","NE7  7","NE7  7","Total",15468,7620,7848,14782,686,200,395.38,39.1
"2011","NE70 7","NE70 7","Total",1754,876,878,1751,3,33,8758.40,0.2
"2011","NE71 6","NE71 6","Total",2949,1410,1539,2927,22,30,26789.45,0.1
"2011","NE8  1","NE8  1","Total",5856,3256,2600,5414,442,70,65.85,88.9
"2011","NE8  2","NE8  2","Total",7164,3825,3339,7041,123,23,244.05,29.4
"2011","NE8  3","NE8  3","Total",8285,4244,4041,8171,114,29,228.85,36.2
"2011","NE8  4","NE8  4","Total",12125,6023,6102,11618,507,74,393.62,30.8
"2011","NE9  5","NE9  5","Total",10263,4946,5317,10138,125,78,201.52,50.9
"2011","NE9  6","NE9  6","Total",15719,7616,8103,15491,228,117,334.11,47.0
"2011","NE9  7","NE9  7","Total",11526,5546,5980,11397,129,44,771.95,14.9
"2011","NG1  1","NG1  1","Total",3786,2254,1532,3481,305,27,38.14,99.3
"2011","NG1  3","NG1  3","Total",2603,1543,1060,2599,4,21,23.19,112.2
"2011","NG1  4","NG1  4","Total",3940,2016,1924,2611,1329,71,47.44,83.1
"2011","NG1  5","NG1  5","Total",1795,951,844,1454,341,15,23.98,74.9
"2011","NG1  6","NG1  6","Total",281,156,125,247,34,0,5.46,51.5
"2011","NG1  7","NG1  7","Total",492,307,185,444,48,6,33.71,14.6
"2011","NG10 1","NG10 1","Total",7938,3963,3975,7899,39,42,213.66,37.2
"2011","NG10 2","NG10 2","Total",4613,2319,2294,4565,48,38,446.05,10.3
"2011","NG10 3","NG10 3","Total",14380,7075,7305,14373,7,148,536.97,26.8
"2011","NG10 4","NG10 4","Total",10829,5303,5526,10637,192,90,254.65,42.5
"2011","NG10 5","NG10 5","Total",8889,4305,4584,8803,86,77,444.87,20.0
"2011","NG11 0","NG11 0","Total",2431,1196,1235,2431,0,34,3213.11,0.8
"2011","NG11 6","NG11 6","Total",8233,3990,4243,8087,146,154,2543.35,3.2
"2011","NG11 7","NG11 7","Total",4428,2186,2242,4428,0,61,153.06,28.9
"2011","NG11 8","NG11 8","Total",13340,6485,6855,12562,778,109,560.90,23.8
"2011","NG11 9","NG11 9","Total",9067,4403,4664,9058,9,41,181.54,49.9
"2011","NG12 1","NG12 1","Total",2527,1234,1293,2506,21,34,1057.08,2.4
"2011","NG12 2","NG12 2","Total",6537,3130,3407,6381,156,113,1791.15,3.6
"2011","NG12 3","NG12 3","Total",10862,5321,5541,10697,165,141,6064.84,1.8
"2011","NG12 4","NG12 4","Total",4857,2413,2444,4857,0,101,1407.07,3.5
"2011","NG12 5","NG12 5","Total",8382,4099,4283,8320,62,156,3998.69,2.1
"2011","NG13 0","NG13 0","Total",4508,2185,2323,4508,0,71,4633.21,1.0
"2011","NG13 8","NG13 8","Total",11712,5648,6064,11664,48,193,4217.10,2.8
"2011","NG13 9","NG13 9","Total",5164,2949,2215,4306,858,84,7374.76,0.7
"2011","NG14 5","NG14 5","Total",3922,1905,2017,3911,11,62,1375.25,2.9
"2011","NG14 6","NG14 6","Total",9537,4621,4916,9471,66,134,4131.18,2.3
"2011","NG14 7","NG14 7","Total",5980,3342,2638,5052,928,115,3425.95,1.7
"2011","NG15 0","NG15 0","Total",2076,1019,1057,2059,17,21,1973.01,1.1
"2011","NG15 6","NG15 6","Total",14763,7288,7475,14648,115,117,956.47,15.4
"2011","NG15 7","NG15 7","Total",12829,6236,6593,12655,174,76,486.56,26.4
"2011","NG15 8","NG15 8","Total",5271,2568,2703,5210,61,55,1557.65,3.4
"2011","NG15 9","NG15 9","Total",5759,2802,2957,5756,3,123,1464.37,3.9
"2011","NG16 1","NG16 1","Total",9349,4623,4726,9332,17,122,949.45,9.8
"2011","NG16 2","NG16 2","Total",16473,8164,8309,16439,34,145,1733.53,9.5
"2011","NG16 3","NG16 3","Total",10812,5338,5474,10667,145,72,1014.77,10.7
"2011","NG16 4","NG16 4","Total",5405,2646,2759,5405,0,31,717.02,7.5
"2011","NG16 5","NG16 5","Total",10047,4928,5119,9988,59,66,1527.18,6.6
"2011","NG16 6","NG16 6","Total",11465,5698,5767,11354,111,52,1186.45,9.7
"2011","NG17 1","NG17 1","Total",6439,3203,3236,6374,65,48,243.95,26.4
"2011","NG17 2","NG17 2","Total",14585,7071,7514,14287,298,88,744.35,19.6
"2011","NG17 3","NG17 3","Total",8900,4362,4538,8857,43,57,1671.09,5.3
"2011","NG17 4","NG17 4","Total",9768,4918,4850,9664,104,48,232.28,42.1
"2011","NG17 5","NG17 5","Total",6475,3149,3326,6475,0,31,458.49,14.1
"2011","NG17 7","NG17 7","Total",9204,4499,4705,9060,144,56,869.04,10.6
"2011","NG17 8","NG17 8","Total",11236,5523,5713,11177,59,99,1083.09,10.4
"2011","NG17 9","NG17 9","Total",6179,3058,3121,6159,20,33,457.73,13.5
"2011","NG18 1","NG18 1","Total",1438,743,695,1354,84,12,75.68,19.0
"2011","NG18 2","NG18 2","Total",7952,3967,3985,7777,175,48,229.36,34.7
"2011","NG18 3","NG18 3","Total",11644,5710,5934,11597,47,101,542.87,21.4
"2011","NG18 4","NG18 4","Total",12656,6242,6414,12486,170,164,1590.51,8.0
"2011","NG18 5","NG18 5","Total",7836,3895,3941,7743,93,75,316.69,24.7
"2011","NG19 0","NG19 0","Total",11328,5515,5813,11260,68,109,522.01,21.7
"2011","NG19 6","NG19 6","Total",11773,5702,6071,11702,71,57,305.79,38.5
"2011","NG19 7","NG19 7","Total",9163,4471,4692,9032,131,77,964.14,9.5
"2011","NG19 8","NG19 8","Total",10182,4965,5217,10108,74,76,1088.96,9.4
"2011","NG19 9","NG19 9","Total",9830,4873,4957,9819,11,125,428.26,23.0
"2011","NG2  1","NG2  1","Total",2255,1143,1112,2255,0,14,153.84,14.7
"2011","NG2  2","NG2  2","Total",6140,3206,2934,5718,422,33,101.55,60.5
"2011","NG2  3","NG2  3","Total",1789,978,811,1789,0,3,85.56,20.9
"2011","NG2  4","NG2  4","Total",10318,5570,4748,10252,66,67,351.69,29.3
"2011","NG2  5","NG2  5","Total",9159,4640,4519,9119,40,172,251.57,36.4
"2011","NG2  6","NG2  6","Total",12428,5996,6432,12382,46,231,405.43,30.7
"2011","NG2  7","NG2  7","Total",16520,8190,8330,16348,172,363,527.19,31.3
"2011","NG20 0","NG20 0","Total",9264,4529,4735,9171,93,68,2129.39,4.4
"2011","NG20 8","NG20 8","Total",9976,4825,5151,9878,98,42,1113.30,9.0
"2011","NG20 9","NG20 9","Total",6950,3440,3510,6862,88,33,2192.73,3.2
"2011","NG21 0","NG21 0","Total",12150,5948,6202,11981,169,90,2578.12,4.7
"2011","NG21 9","NG21 9","Total",10031,4882,5149,9882,149,87,3494.80,2.9
"2011","NG22 0","NG22 0","Total",6804,3347,3457,6767,37,129,13192.88,0.5
"2011","NG22 8","NG22 8","Total",7649,3798,3851,7535,114,122,6450.32,1.2
"2011","NG22 9","NG22 9","Total",11840,5845,5995,11723,117,106,6097.92,1.9
"2011","NG23 5","NG23 5","Total",7164,3481,3683,7123,41,169,12187.02,0.6
"2011","NG23 6","NG23 6","Total",5345,2624,2721,5330,15,111,9023.71,0.6
"2011","NG23 7","NG23 7","Total",4736,2343,2393,4662,74,65,8399.13,0.6
"2011","NG24 1","NG24 1","Total",6771,3399,3372,6723,48,44,460.22,14.7
"2011","NG24 2","NG24 2","Total",10382,5133,5249,10296,86,135,2351.56,4.4
"2011","NG24 3","NG24 3","Total",13627,6659,6968,13565,62,139,3088.37,4.4
"2011","NG24 4","NG24 4","Total",14025,6729,7296,13843,182,122,480.22,29.2
"2011","NG25 0","NG25 0","Total",8913,4208,4705,8548,365,239,5087.61,1.8
"2011","NG3  1","NG3  1","Total",4721,2365,2356,3627,1094,71,57.63,81.9
"2011","NG3  2","NG3  2","Total",4736,2346,2390,4725,11,30,97.14,48.8
"2011","NG3  3","NG3  3","Total",7058,3499,3559,6983,75,42,88.69,79.6
"2011","NG3  4","NG3  4","Total",4123,2165,1958,3901,222,38,94.17,43.8
"2011","NG3  5","NG3  5","Total",9332,4709,4623,9023,309,147,231.24,40.4
"2011","NG3  6","NG3  6","Total",10910,5395,5515,10852,58,110,268.44,40.6
"2011","NG3  7","NG3  7","Total",7308,3576,3732,7291,17,29,175.55,41.6
"2011","NG31 6","NG31 6","Total",3510,1754,1756,3455,55,23,127.26,27.6
"2011","NG31 7","NG31 7","Total",13714,6658,7056,13697,17,123,773.07,17.7
"2011","NG31 8","NG31 8","Total",13855,6676,7179,13639,216,271,2485.55,5.6
"2011","NG31 9","NG31 9","Total",13262,6405,6857,13087,175,145,1792.43,7.4
"2011","NG32 1","NG32 1","Total",4215,2055,2160,4196,19,70,7881.43,0.5
"2011","NG32 2","NG32 2","Total",3505,1721,1784,3505,0,86,8102.22,0.4
"2011","NG32 3","NG32 3","Total",4708,2306,2402,4678,30,78,9099.96,0.5
"2011","NG33 4","NG33 4","Total",4789,2342,2447,4789,0,138,15449.51,0.3
"2011","NG33 5","NG33 5","Total",5070,2541,2529,5069,1,76,11351.05,0.4
"2011","NG34 0","NG34 0","Total",5926,2848,3078,5895,31,102,15874.84,0.4
"2011","NG34 7","NG34 7","Total",12895,6202,6693,12775,120,171,845.29,15.3
"2011","NG34 8","NG34 8","Total",11199,5550,5649,10983,216,190,12480.96,0.9
"2011","NG34 9","NG34 9","Total",11182,5445,5737,11075,107,139,10934.98,1.0
"2011","NG4  1","NG4  1","Total",12868,6426,6442,12857,11,80,256.39,50.2
"2011","NG4  2","NG4  2","Total",8671,4216,4455,8630,41,43,370.36,23.4
"2011","NG4  3","NG4  3","Total",10491,5108,5383,10309,182,107,211.93,49.5
"2011","NG4  4","NG4  4","Total",8805,4363,4442,8740,65,64,1356.59,6.5
"2011","NG5  1","NG5  1","Total",9262,4581,4681,8839,423,72,172.27,53.8
"2011","NG5  2","NG5  2","Total",5919,3002,2917,5776,143,66,75.43,78.5
"2011","NG5  3","NG5  3","Total",5612,2882,2730,4997,615,70,148.60,37.8
"2011","NG5  4","NG5  4","Total",9505,4653,4852,9346,159,144,253.54,37.5
"2011","NG5  5","NG5  5","Total",16756,8134,8622,16650,106,82,314.79,53.2
"2011","NG5  6","NG5  6","Total",12113,5847,6266,12086,27,124,246.18,49.2
"2011","NG5  7","NG5  7","Total",7272,3452,3820,7201,71,51,147.51,49.3
"2011","NG5  8","NG5  8","Total",11789,5651,6138,11716,73,112,549.07,21.5
"2011","NG5  9","NG5  9","Total",9327,4388,4939,9325,2,75,208.96,44.6
"2011","NG6  0","NG6  0","Total",8889,4378,4511,8686,203,45,199.24,44.6
"2011","NG6  7","NG6  7","Total",4600,2269,2331,4583,17,18,103.21,44.6
"2011","NG6  8","NG6  8","Total",15552,7341,8211,15291,261,71,1522.96,10.2
"2011","NG6  9","NG6  9","Total",8444,4064,4380,8370,74,59,169.11,49.9
"2011","NG7  1","NG7  1","Total",11780,6552,5228,11579,201,126,164.22,71.7
"2011","NG7  2","NG7  2","Total",13506,7093,6413,9171,4335,185,665.06,20.3
"2011","NG7  3","NG7  3","Total",6924,3832,3092,5536,1388,71,73.38,94.4
"2011","NG7  4","NG7  4","Total",5005,2651,2354,4333,672,28,91.69,54.6
"2011","NG7  5","NG7  5","Total",7846,4129,3717,7840,6,58,90.88,86.3
"2011","NG7  6","NG7  6","Total",8848,4728,4120,8809,39,48,85.20,103.8
"2011","NG7  7","NG7  7","Total",4103,2078,2025,4090,13,19,51.69,79.4
"2011","NG8  1","NG8  1","Total",9746,4978,4768,9208,538,149,378.68,25.7
"2011","NG8  2","NG8  2","Total",11094,5378,5716,11094,0,216,343.45,32.3
"2011","NG8  3","NG8  3","Total",9804,4709,5095,9669,135,66,312.94,31.3
"2011","NG8  4","NG8  4","Total",8152,3911,4241,8110,42,60,748.27,10.9
"2011","NG8  5","NG8  5","Total",13255,6395,6860,13255,0,101,260.82,50.8
"2011","NG8  6","NG8  6","Total",11910,5538,6372,11904,6,46,283.71,42.0
"2011","NG9  1","NG9  1","Total",10052,4984,5068,9836,216,93,356.25,28.2
"2011","NG9  2","NG9  2","Total",13412,6758,6654,11725,1687,135,219.69,61.0
"2011","NG9  3","NG9  3","Total",11156,5478,5678,11108,48,203,1144.52,9.7
"2011","NG9  4","NG9  4","Total",5785,2775,3010,5743,42,70,159.69,36.2
"2011","NG9  5","NG9  5","Total",8186,4074,4112,7943,243,137,268.67,30.5
"2011","NG9  6","NG9  6","Total",9381,4582,4799,9303,78,143,723.85,13.0
"2011","NG9  7","NG9  7","Total",6003,2952,3051,6003,0,69,165.90,36.2
"2011","NG9  8","NG9  8","Total",9238,4533,4705,9210,28,60,262.18,35.2
"2011","NN1  1","NN1  1","Total",1701,929,772,1700,1,11,143.52,11.9
"2011","NN1  2","NN1  2","Total",3140,1683,1457,3140,0,12,61.49,51.1
"2011","NN1  3","NN1  3","Total",6228,3330,2898,6195,33,45,58.45,106.6
"2011","NN1  4","NN1  4","Total",10540,5292,5248,10307,233,114,106.17,99.3
"2011","NN1  5","NN1  5","Total",8225,4291,3934,7677,548,100,278.01,29.6
"2011","NN10 0","NN10 0","Total",13451,6647,6804,13289,162,129,935.91,14.4
"2011","NN10 6","NN10 6","Total",5632,2763,2869,5493,139,57,406.25,13.9
"2011","NN10 8","NN10 8","Total",8083,3988,4095,8020,63,77,854.76,9.5
"2011","NN10 9","NN10 9","Total",11065,5450,5615,11015,50,85,898.58,12.3
"2011","NN11 0","NN11 0","Total",5373,2666,2707,5373,0,62,230.21,23.3
"2011","NN11 2","NN11 2","Total",1313,629,684,1313,0,42,2804.04,0.5
"2011","NN11 3","NN11 3","Total",6290,3124,3166,6232,58,151,9018.15,0.7
"2011","NN11 4","NN11 4","Total",11581,5681,5900,11400,181,100,871.11,13.3
"2011","NN11 6","NN11 6","Total",3054,1522,1532,3028,26,90,5408.20,0.6
"2011","NN11 7","NN11 7","Total",1759,862,897,1759,0,24,1318.26,1.3
"2011","NN11 8","NN11 8","Total",1488,752,736,1488,0,20,190.42,7.8
"2011","NN11 9","NN11 9","Total",6584,3249,3335,6584,0,45,177.73,37.0
"2011","NN12 6","NN12 6","Total",7603,3773,3830,7570,33,120,1092.94,7.0
"2011","NN12 7","NN12 7","Total",6189,3079,3110,6125,64,131,4806.34,1.3
"2011","NN12 8","NN12 8","Total",9235,4650,4585,9155,80,285,14186.95,0.7
"2011","NN13 5","NN13 5","Total",5528,2764,2764,5425,103,156,12922.45,0.4
"2011","NN13 6","NN13 6","Total",10250,5126,5124,10146,104,195,1963.55,5.2
"2011","NN13 7","NN13 7","Total",2950,1443,1507,2908,42,39,160.76,18.4
"2011","NN14 1","NN14 1","Total",10009,4881,5128,9990,19,162,8457.58,1.2
"2011","NN14 2","NN14 2","Total",10697,5251,5446,10549,148,113,967.53,11.1
"2011","NN14 3","NN14 3","Total",4349,2175,2174,4317,32,108,10929.44,0.4
"2011","NN14 4","NN14 4","Total",10520,5256,5264,10442,78,170,5264.21,2.0
"2011","NN14 6","NN14 6","Total",7694,3752,3942,7688,6,83,1372.17,5.6
"2011","NN15 5","NN15 5","Total",14736,7196,7540,14704,32,210,1478.11,10.0
"2011","NN15 6","NN15 6","Total",13282,6476,6806,13109,173,177,618.09,21.5
"2011","NN15 7","NN15 7","Total",5947,2927,3020,5872,75,90,215.86,27.6
"2011","NN16 0","NN16 0","Total",7566,3706,3860,7478,88,56,189.06,40.0
"2011","NN16 8","NN16 8","Total",7921,4037,3884,7792,129,64,257.26,30.8
"2011","NN16 9","NN16 9","Total",14656,7223,7433,14394,262,167,1483.23,9.9
"2011","NN17 1","NN17 1","Total",9666,4818,4848,9577,89,76,794.22,12.2
"2011","NN17 2","NN17 2","Total",12295,6014,6281,12239,56,93,277.83,44.3
"2011","NN17 3","NN17 3","Total",4163,2085,2078,4078,85,67,7794.29,0.5
"2011","NN17 4","NN17 4","Total",585,274,311,585,0,2,186.96,3.1
"2011","NN18 0","NN18 0","Total",8803,4290,4513,8792,11,81,213.83,41.2
"2011","NN18 8","NN18 8","Total",14719,7317,7402,14669,50,135,2009.85,7.3
"2011","NN18 9","NN18 9","Total",9389,4569,4820,9383,6,81,271.92,34.5
"2011","NN2  6","NN2  6","Total",9413,4782,4631,9167,246,61,265.52,35.5
"2011","NN2  7","NN2  7","Total",14586,6865,7721,13048,1538,167,341.71,42.7
"2011","NN2  8","NN2  8","Total",14140,6893,7247,13959,181,168,877.66,16.1
"2011","NN29 7","NN29 7","Total",11520,5717,5803,11378,142,130,6358.71,1.8
"2011","NN3  2","NN3  2","Total",11653,5684,5969,11586,67,124,222.98,52.3
"2011","NN3  3","NN3  3","Total",9133,4457,4676,9031,102,163,349.94,26.1
"2011","NN3  5","NN3  5","Total",9237,4429,4808,9145,92,96,206.47,44.7
"2011","NN3  6","NN3  6","Total",6916,3269,3647,6821,95,76,360.65,19.2
"2011","NN3  7","NN3  7","Total",5931,2886,3045,5782,149,93,1112.60,5.3
"2011","NN3  8","NN3  8","Total",16057,7736,8321,16009,48,142,401.38,40.0
"2011","NN3  9","NN3  9","Total",9659,4696,4963,9651,8,114,584.71,16.5
"2011","NN4  0","NN4  0","Total",10706,5283,5423,10631,75,169,476.44,22.5
"2011","NN4  5","NN4  5","Total",4404,2193,2211,4342,62,57,218.12,20.2
"2011","NN4  6","NN4  6","Total",10674,5232,5442,10650,24,153,844.33,12.6
"2011","NN4  7","NN4  7","Total",642,313,329,642,0,13,366.22,1.8
"2011","NN4  8","NN4  8","Total",14515,7111,7404,14485,30,102,609.88,23.8
"2011","NN4  9","NN4  9","Total",5773,2797,2976,5773,0,106,389.02,14.8
"2011","NN5  4","NN5  4","Total",4252,2062,2190,4208,44,25,554.38,7.7
"2011","NN5  5","NN5  5","Total",7086,3574,3512,6973,113,29,229.25,30.9
"2011","NN5  6","NN5  6","Total",15997,7813,8184,15915,82,153,387.94,41.2
"2011","NN5  7","NN5  7","Total",10715,5082,5633,10592,123,66,526.85,20.3
"2011","NN6  0","NN6  0","Total",7859,3828,4031,7833,26,133,4012.64,2.0
"2011","NN6  6","NN6  6","Total",3043,1527,1516,3043,0,84,7074.61,0.4
"2011","NN6  7","NN6  7","Total",7837,3879,3958,7789,48,171,6261.43,1.3
"2011","NN6  8","NN6  8","Total",5329,2613,2716,5309,20,151,8437.44,0.6
"2011","NN6  9","NN6  9","Total",9256,4561,4695,9058,198,234,11127.51,0.8
"2011","NN7  1","NN7  1","Total",4644,2288,2356,4640,4,99,5975.24,0.8
"2011","NN7  2","NN7  2","Total",6678,3302,3376,6656,22,132,5924.14,1.1
"2011","NN7  3","NN7  3","Total",7891,3800,4091,7825,66,132,3939.42,2.0
"2011","NN7  4","NN7  4","Total",8086,3994,4092,8086,0,137,7315.14,1.1
"2011","NN8  1","NN8  1","Total",7082,3581,3501,7009,73,75,560.06,12.6
"2011","NN8  2","NN8  2","Total",11325,5602,5723,11026,299,107,1000.08,11.3
"2011","NN8  3","NN8  3","Total",12439,5929,6510,12300,139,95,482.97,25.8
"2011","NN8  4","NN8  4","Total",10554,5182,5372,10443,111,116,399.10,26.4
"2011","NN8  5","NN8  5","Total",7647,3781,3866,7630,17,127,374.85,20.4
"2011","NN9  5","NN9  5","Total",14887,7394,7493,14755,132,150,4308.76,3.5
"2011","NN9  6","NN9  6","Total",11390,5659,5731,11232,158,151,4408.58,2.6
"2011","NR1  1","NR1  1","Total",4788,2600,2188,4692,96,37,186.15,25.7
"2011","NR1  2","NR1  2","Total",8023,3870,4153,7962,61,87,239.51,33.5
"2011","NR1  3","NR1  3","Total",4305,2224,2081,4216,89,34,86.46,49.8
"2011","NR1  4","NR1  4","Total",7675,3989,3686,7245,430,55,223.96,34.3
"2011","NR10 3","NR10 3","Total",10594,5227,5367,10435,159,99,3818.62,2.8
"2011","NR10 4","NR10 4","Total",5573,2746,2827,5555,18,86,6839.72,0.8
"2011","NR10 5","NR10 5","Total",6645,3625,3020,6023,622,63,6322.77,1.1
"2011","NR11 6","NR11 6","Total",7772,3726,4046,7703,69,122,8226.56,0.9
"2011","NR11 7","NR11 7","Total",2976,1477,1499,2976,0,59,7912.33,0.4
"2011","NR11 8","NR11 8","Total",6933,3361,3572,6851,82,121,6206.79,1.1
"2011","NR12 0","NR12 0","Total",4503,2215,2288,4430,73,36,5583.90,0.8
"2011","NR12 7","NR12 7","Total",3427,1652,1775,3345,82,46,2796.91,1.2
"2011","NR12 8","NR12 8","Total",6715,3229,3486,6550,165,74,6830.46,1.0
"2011","NR12 9","NR12 9","Total",5790,2810,2980,5714,76,62,3814.77,1.5
"2011","NR13 3","NR13 3","Total",6802,3332,3470,6724,78,83,7620.47,0.9
"2011","NR13 4","NR13 4","Total",6925,3335,3590,6888,37,88,3352.68,2.1
"2011","NR13 5","NR13 5","Total",7558,3688,3870,7398,160,105,2372.41,3.2
"2011","NR13 6","NR13 6","Total",5404,2611,2793,5320,84,77,5545.26,1.0
"2011","NR14 6","NR14 6","Total",7305,3561,3744,7181,124,125,9246.30,0.8
"2011","NR14 7","NR14 7","Total",8272,4063,4209,8196,76,134,5231.78,1.6
"2011","NR14 8","NR14 8","Total",8170,3919,4251,8114,56,160,5321.71,1.5
"2011","NR15 1","NR15 1","Total",6850,3310,3540,6751,99,121,6999.51,1.0
"2011","NR15 2","NR15 2","Total",8956,4436,4520,8917,39,109,7412.72,1.2
"2011","NR16 1","NR16 1","Total",5532,2710,2822,5511,21,94,6756.43,0.8
"2011","NR16 2","NR16 2","Total",6421,3160,3261,6275,146,93,9736.07,0.7
"2011","NR17 1","NR17 1","Total",7062,3569,3493,6998,64,90,9483.06,0.7
"2011","NR17 2","NR17 2","Total",8710,4246,4464,8607,103,100,1552.14,5.6
"2011","NR18 0","NR18 0","Total",12223,5878,6345,12133,90,184,1880.00,6.5
"2011","NR18 9","NR18 9","Total",5333,2648,2685,4638,695,106,7157.01,0.7
"2011","NR19 1","NR19 1","Total",11053,5356,5697,10976,77,88,1967.32,5.6
"2011","NR19 2","NR19 2","Total",9306,4548,4758,9153,153,118,4963.27,1.9
"2011","NR2  1","NR2  1","Total",1114,556,558,1081,33,10,37.22,29.9
"2011","NR2  2","NR2  2","Total",6762,3239,3523,6676,86,117,130.75,51.7
"2011","NR2  3","NR2  3","Total",12032,5780,6252,11970,62,199,205.21,58.6
"2011","NR2  4","NR2  4","Total",6043,3008,3035,6043,0,37,137.23,44.0
"2011","NR20 3","NR20 3","Total",7439,3599,3840,7244,195,110,6721.73,1.1
"2011","NR20 4","NR20 4","Total",6941,3510,3431,6545,396,87,5694.11,1.2
"2011","NR20 5","NR20 5","Total",4951,2454,2497,4887,64,80,10290.34,0.5
"2011","NR21 0","NR21 0","Total",3250,1588,1662,3247,3,65,10115.82,0.3
"2011","NR21 7","NR21 7","Total",3295,1641,1654,3295,0,42,6116.40,0.5
"2011","NR21 8","NR21 8","Total",5164,2448,2716,5103,61,33,375.08,13.8
"2011","NR21 9","NR21 9","Total",4106,2015,2091,4062,44,49,4896.79,0.8
"2011","NR22 6","NR22 6","Total",819,395,424,811,8,13,1897.51,0.4
"2011","NR23 1","NR23 1","Total",3009,1441,1568,2965,44,41,6693.54,0.4
"2011","NR24 2","NR24 2","Total",4462,2191,2271,4424,38,63,6233.42,0.7
"2011","NR25 6","NR25 6","Total",5511,2568,2943,5148,363,84,3931.66,1.4
"2011","NR25 7","NR25 7","Total",3367,1622,1745,3324,43,67,7887.72,0.4
"2011","NR26 8","NR26 8","Total",8299,3877,4422,8090,209,106,1120.20,7.4
"2011","NR27 0","NR27 0","Total",5250,2453,2797,5032,218,44,710.46,7.4
"2011","NR27 9","NR27 9","Total",6483,3149,3334,6225,258,73,1636.71,4.0
"2011","NR28 0","NR28 0","Total",9282,4477,4805,9138,144,86,4241.48,2.2
"2011","NR28 9","NR28 9","Total",8250,3932,4318,8105,145,72,5411.93,1.5
"2011","NR29 3","NR29 3","Total",6914,3387,3527,6880,34,98,6242.00,1.1
"2011","NR29 4","NR29 4","Total",8411,4060,4351,8240,171,108,3247.06,2.6
"2011","NR29 5","NR29 5","Total",4599,2292,2307,4509,90,40,4264.69,1.1
"2011","NR3  1","NR3  1","Total",4742,2387,2355,4657,85,40,91.34,51.9
"2011","NR3  2","NR3  2","Total",8834,4388,4446,8808,26,33,250.82,35.2
"2011","NR3  3","NR3  3","Total",10413,5213,5200,10243,170,67,204.78,50.8
"2011","NR3  4","NR3  4","Total",8982,4496,4486,8807,175,41,159.82,56.2
"2011","NR30 1","NR30 1","Total",4431,2187,2244,4325,106,11,651.47,6.8
"2011","NR30 2","NR30 2","Total",5565,2926,2639,5433,132,30,87.15,63.9
"2011","NR30 3","NR30 3","Total",4419,2214,2205,4381,38,13,193.14,22.9
"2011","NR30 4","NR30 4","Total",7210,3450,3760,7090,120,35,267.98,26.9
"2011","NR30 5","NR30 5","Total",9076,4375,4701,9022,54,67,1072.66,8.5
"2011","NR31 0","NR31 0","Total",7144,3586,3558,7115,29,40,316.54,22.6
"2011","NR31 6","NR31 6","Total",8799,4275,4524,8641,158,79,214.49,41.0
"2011","NR31 7","NR31 7","Total",11015,5367,5648,10943,72,70,262.98,41.9
"2011","NR31 8","NR31 8","Total",13107,6395,6712,13046,61,88,939.94,13.9
"2011","NR31 9","NR31 9","Total",9849,4876,4973,9801,48,95,2826.55,3.5
"2011","NR32 1","NR32 1","Total",3922,1932,1990,3877,45,35,125.74,31.2
"2011","NR32 2","NR32 2","Total",9238,4516,4722,9227,11,48,225.78,40.9
"2011","NR32 3","NR32 3","Total",8222,4006,4216,8110,112,77,359.49,22.9
"2011","NR32 4","NR32 4","Total",13267,6419,6848,13118,149,123,535.58,24.8
"2011","NR32 5","NR32 5","Total",4008,2193,1815,3518,490,50,3520.07,1.1
"2011","NR33 0","NR33 0","Total",8315,4092,4223,8009,306,79,213.01,39.0
"2011","NR33 7","NR33 7","Total",9176,4411,4765,9128,48,91,879.28,10.4
"2011","NR33 8","NR33 8","Total",13572,6592,6980,13462,110,138,1608.65,8.4
"2011","NR33 9","NR33 9","Total",8404,4011,4393,8404,0,59,262.95,32.0
"2011","NR34 0","NR34 0","Total",2235,1122,1113,2235,0,38,4377.64,0.5
"2011","NR34 7","NR34 7","Total",7729,3758,3971,7729,0,97,7464.95,1.0
"2011","NR34 8","NR34 8","Total",3002,1492,1510,2990,12,61,8175.13,0.4
"2011","NR34 9","NR34 9","Total",9303,4439,4864,9175,128,81,786.65,11.8
"2011","NR35 1","NR35 1","Total",5723,2767,2956,5586,137,59,3504.78,1.6
"2011","NR35 2","NR35 2","Total",5171,2536,2635,5088,83,91,7470.32,0.7
"2011","NR4  6","NR4  6","Total",8885,4262,4623,8881,4,181,1043.48,8.5
"2011","NR4  7","NR4  7","Total",12637,5898,6739,9300,3337,281,1107.78,11.4
"2011","NR5  0","NR5  0","Total",8438,4180,4258,8424,14,44,357.86,23.6
"2011","NR5  8","NR5  8","Total",12837,6218,6619,12825,12,74,264.36,48.6
"2011","NR5  9","NR5  9","Total",8013,3926,4087,7959,54,60,234.08,34.2
"2011","NR6  5","NR6  5","Total",7104,3432,3672,6960,144,50,496.36,14.3
"2011","NR6  6","NR6  6","Total",7506,3763,3743,7506,0,55,485.48,15.5
"2011","NR6  7","NR6  7","Total",9298,4517,4781,9258,40,90,345.41,26.9
"2011","NR7  0","NR7  0","Total",13532,6616,6916,13318,214,166,686.60,19.7
"2011","NR7  8","NR7  8","Total",11040,5367,5673,10972,68,104,689.96,16.0
"2011","NR7  9","NR7  9","Total",7239,3474,3765,7180,59,33,313.56,23.1
"2011","NR8  5","NR8  5","Total",4605,2278,2327,4604,1,46,914.26,5.0
"2011","NR8  6","NR8  6","Total",15881,7741,8140,15499,382,188,1930.81,8.2
"2011","NR9  3","NR9  3","Total",7346,3510,3836,7262,84,129,2972.98,2.5
"2011","NR9  4","NR9  4","Total",4677,2274,2403,4644,33,91,5991.90,0.8
"2011","NR9  5","NR9  5","Total",4822,2388,2434,4718,104,99,7833.92,0.6
"2011","NW1  0","NW1  0","Total",6902,3397,3505,6731,171,66,53.39,129.3
"2011","NW1  1","NW1  1","Total",7612,3668,3944,7507,105,72,96.61,78.8
"2011","NW1  2","NW1  2","Total",1874,896,978,1830,44,11,31.97,58.6
"2011","NW1  3","NW1  3","Total",6985,3603,3382,6641,344,51,28.81,242.5
"2011","NW1  4","NW1  4","Total",3045,1448,1597,2981,64,94,164.45,18.5
"2011","NW1  5","NW1  5","Total",3068,1547,1521,2961,107,30,14.08,217.9
"2011","NW1  6","NW1  6","Total",5546,2859,2687,5500,46,82,26.40,210.1
"2011","NW1  7","NW1  7","Total",6486,3352,3134,6360,126,102,74.73,86.8
"2011","NW1  8","NW1  8","Total",8474,4114,4360,8389,85,85,53.98,157.0
"2011","NW1  9","NW1  9","Total",10347,5090,5257,9807,540,84,62.44,165.7
"2011","NW10 0","NW10 0","Total",11063,5326,5737,11063,0,70,184.56,59.9
"2011","NW10 1","NW10 1","Total",10006,5015,4991,9997,9,106,124.44,80.4
"2011","NW10 2","NW10 2","Total",9068,4540,4528,9008,60,78,105.37,86.1
"2011","NW10 3","NW10 3","Total",8483,4082,4401,8469,14,112,124.82,68.0
"2011","NW10 4","NW10 4","Total",10100,5103,4997,10053,47,79,67.02,150.7
"2011","NW10 5","NW10 5","Total",13687,6790,6897,13673,14,127,95.09,143.9
"2011","NW10 6","NW10 6","Total",2729,1348,1381,2717,12,16,215.84,12.6
"2011","NW10 7","NW10 7","Total",3606,1793,1813,3588,18,36,244.52,14.7
"2011","NW10 8","NW10 8","Total",13236,6476,6760,13206,30,120,135.89,97.4
"2011","NW10 9","NW10 9","Total",10019,4887,5132,10010,9,96,83.14,120.5
"2011","NW11 0","NW11 0","Total",6691,3232,3459,6646,45,224,85.63,78.1
"2011","NW11 6","NW11 6","Total",6367,2958,3409,6354,13,128,161.84,39.3
"2011","NW11 7","NW11 7","Total",5285,2488,2797,5284,1,117,132.03,40.0
"2011","NW11 8","NW11 8","Total",6889,3395,3494,6750,139,146,109.42,63.0
"2011","NW11 9","NW11 9","Total",7452,3682,3770,7284,168,215,68.07,109.5
"2011","NW2  1","NW2  1","Total",8799,4321,4478,8676,123,107,204.87,42.9
"2011","NW2  2","NW2  2","Total",7460,3595,3865,7217,243,117,108.61,68.7
"2011","NW2  3","NW2  3","Total",10316,5321,4995,10274,42,85,80.00,128.9
"2011","NW2  4","NW2  4","Total",7841,4043,3798,7799,42,81,82.97,94.5
"2011","NW2  5","NW2  5","Total",10054,5046,5008,10028,26,80,73.78,136.3
"2011","NW2  6","NW2  6","Total",11527,5763,5764,11523,4,91,142.50,80.9
"2011","NW2  7","NW2  7","Total",10971,5524,5447,10949,22,105,165.18,66.4
"2011","NW3  1","NW3  1","Total",5050,2485,2565,4977,73,126,76.06,66.4
"2011","NW3  2","NW3  2","Total",12990,6226,6764,12964,26,149,128.44,101.1
"2011","NW3  3","NW3  3","Total",8166,3891,4275,8113,53,134,69.17,118.1
"2011","NW3  4","NW3  4","Total",8626,4130,4496,8523,103,99,57.07,151.1
"2011","NW3  5","NW3  5","Total",5388,2621,2767,5316,72,80,59.53,90.5
"2011","NW3  6","NW3  6","Total",6067,2930,3137,5845,222,79,61.80,98.2
"2011","NW3  7","NW3  7","Total",5604,2719,2885,5125,479,120,165.18,33.9
"2011","NW4  1","NW4  1","Total",6515,3172,3343,6451,64,123,98.31,66.3
"2011","NW4  2","NW4  2","Total",8335,4117,4218,8333,2,146,108.25,77.0
"2011","NW4  3","NW4  3","Total",9180,4592,4588,9103,77,108,145.31,63.2
"2011","NW4  4","NW4  4","Total",7902,3942,3960,7723,179,108,156.02,50.6
"2011","NW5  1","NW5  1","Total",8703,4178,4525,8632,71,130,158.51,54.9
"2011","NW5  2","NW5  2","Total",9675,4523,5152,9603,72,103,62.10,155.8
"2011","NW5  3","NW5  3","Total",3842,1846,1996,3832,10,45,31.09,123.6
"2011","NW5  4","NW5  4","Total",8905,4287,4618,8666,239,96,49.53,179.8
"2011","NW6  1","NW6  1","Total",10868,5280,5588,10840,28,103,69.74,155.8
"2011","NW6  2","NW6  2","Total",6295,3007,3288,6289,6,59,46.22,136.2
"2011","NW6  3","NW6  3","Total",7403,3563,3840,7397,6,54,59.62,124.2
"2011","NW6  4","NW6  4","Total",7181,3453,3728,7160,21,74,44.42,161.7
"2011","NW6  5","NW6  5","Total",10843,5328,5515,10761,82,110,63.28,171.3
"2011","NW6  6","NW6  6","Total",8575,4239,4336,8530,45,95,93.20,92.0
"2011","NW6  7","NW6  7","Total",12738,6319,6419,12695,43,132,126.72,100.5
"2011","NW7  1","NW7  1","Total",6383,2999,3384,6368,15,124,466.76,13.7
"2011","NW7  2","NW7  2","Total",7478,3567,3911,7478,0,129,247.13,30.3
"2011","NW7  3","NW7  3","Total",6211,3014,3197,6211,0,100,251.72,24.7
"2011","NW7  4","NW7  4","Total",5598,2712,2886,5510,88,176,372.49,15.0
"2011","NW8  0","NW8  0","Total",7591,3530,4061,7514,77,143,61.39,123.7
"2011","NW8  6","NW8  6","Total",4270,1978,2292,4121,149,93,59.02,72.3
"2011","NW8  7","NW8  7","Total",5147,2473,2674,5137,10,84,80.43,64.0
"2011","NW8  8","NW8  8","Total",10635,5133,5502,10593,42,87,42.58,249.8
"2011","NW8  9","NW8  9","Total",6710,3268,3442,6700,10,108,47.16,142.3
"2011","NW9  0","NW9  0","Total",10434,5235,5199,10324,110,126,129.67,80.5
"2011","NW9  5","NW9  5","Total",16169,7820,8349,15714,455,221,199.12,81.2
"2011","NW9  6","NW9  6","Total",7588,3841,3747,7582,6,100,141.48,53.6
"2011","NW9  7","NW9  7","Total",6393,3118,3275,6387,6,45,161.49,39.6
"2011","NW9  8","NW9  8","Total",10019,5101,4918,9984,35,136,219.74,45.6
"2011","NW9  9","NW9  9","Total",9942,4915,5027,9890,52,110,168.68,58.9
"2011","OL1  2","OL1  2","Total",8465,4259,4206,8405,60,73,305.70,27.7
"2011","OL1  3","OL1  3","Total",3686,1818,1868,3684,2,28,121.40,30.4
"2011","OL1  4","OL1  4","Total",9329,4497,4832,9166,163,59,367.81,25.4
"2011","OL10 1","OL10 1","Total",3418,1741,1677,3347,71,21,118.29,28.9
"2011","OL10 2","OL10 2","Total",7205,3511,3694,7116,89,111,604.46,11.9
"2011","OL10 3","OL10 3","Total",7947,3763,4184,7887,60,37,229.28,34.7
"2011","OL10 4","OL10 4","Total",9224,4481,4743,9207,17,86,745.36,12.4
"2011","OL11 1","OL11 1","Total",6705,3368,3337,6654,51,45,103.00,65.1
"2011","OL11 2","OL11 2","Total",10601,5034,5567,10563,38,66,577.30,18.4
"2011","OL11 3","OL11 3","Total",9313,4514,4799,9091,222,74,305.97,30.4
"2011","OL11 4","OL11 4","Total",7025,3446,3579,6896,129,67,313.28,22.4
"2011","OL11 5","OL11 5","Total",12168,6004,6164,12034,134,279,468.82,26.0
"2011","OL12 0","OL12 0","Total",5407,2606,2801,5401,6,44,132.55,40.8
"2011","OL12 6","OL12 6","Total",12152,6108,6044,11997,155,133,588.18,20.7
"2011","OL12 7","OL12 7","Total",9936,4758,5178,9930,6,169,670.19,14.8
"2011","OL12 8","OL12 8","Total",7500,3708,3792,7466,34,84,1813.93,4.1
"2011","OL12 9","OL12 9","Total",10672,5402,5270,10227,445,103,1362.81,7.8
"2011","OL13 0","OL13 0","Total",3834,1878,1956,3801,33,28,849.58,4.5
"2011","OL13 8","OL13 8","Total",4440,2199,2241,4385,55,67,995.61,4.5
"2011","OL13 9","OL13 9","Total",6825,3356,3469,6799,26,43,514.34,13.3
"2011","OL14 5","OL14 5","Total",4630,2238,2392,4603,27,37,116.12,39.9
"2011","OL14 6","OL14 6","Total",3619,1765,1854,3574,45,57,2293.76,1.6
"2011","OL14 7","OL14 7","Total",3073,1493,1580,3006,67,40,1663.20,1.8
"2011","OL14 8","OL14 8","Total",4159,1970,2189,4094,65,62,1099.06,3.8
"2011","OL15 0","OL15 0","Total",3973,1876,2097,3833,140,36,1685.77,2.4
"2011","OL15 8","OL15 8","Total",5463,2700,2763,5443,20,34,157.54,34.7
"2011","OL15 9","OL15 9","Total",5025,2475,2550,4988,37,53,1053.72,4.8
"2011","OL16 1","OL16 1","Total",445,259,186,387,58,1,44.44,10.0
"2011","OL16 2","OL16 2","Total",10772,5428,5344,10723,49,50,318.94,33.8
"2011","OL16 3","OL16 3","Total",8462,4130,4332,8413,49,97,1833.70,4.6
"2011","OL16 4","OL16 4","Total",11684,5749,5935,11659,25,117,499.95,23.4
"2011","OL16 5","OL16 5","Total",6462,3163,3299,6407,55,45,129.49,49.9
"2011","OL2  5","OL2  5","Total",10587,5140,5447,10473,114,102,497.97,21.3
"2011","OL2  6","OL2  6","Total",12735,6239,6496,12673,62,160,497.25,25.6
"2011","OL2  7","OL2  7","Total",10234,4905,5329,10234,0,89,439.69,23.3
"2011","OL2  8","OL2  8","Total",8793,4239,4554,8670,123,122,670.15,13.1
"2011","OL3  5","OL3  5","Total",7367,3690,3677,7339,28,148,3632.93,2.0
"2011","OL3  6","OL3  6","Total",2819,1356,1463,2819,0,62,252.93,11.1
"2011","OL3  7","OL3  7","Total",4811,2369,2442,4811,0,109,2741.65,1.8
"2011","OL4  1","OL4  1","Total",12723,6322,6401,12655,68,81,152.49,83.4
"2011","OL4  2","OL4  2","Total",9391,4628,4763,9336,55,111,293.04,32.0
"2011","OL4  3","OL4  3","Total",6112,2995,3117,6033,79,58,661.94,9.2
"2011","OL4  4","OL4  4","Total",7790,3831,3959,7765,25,135,397.61,19.6
"2011","OL4  5","OL4  5","Total",9044,4303,4741,8919,125,93,429.97,21.0
"2011","OL5  0","OL5  0","Total",4925,2391,2534,4884,41,43,299.31,16.5
"2011","OL5  9","OL5  9","Total",5996,2954,3042,5953,43,59,566.58,10.6
"2011","OL6  6","OL6  6","Total",5111,2603,2508,5056,55,42,137.48,37.2
"2011","OL6  7","OL6  7","Total",2964,1633,1331,2951,13,11,92.59,32.0
"2011","OL6  8","OL6  8","Total",10154,4960,5194,10127,27,113,641.46,15.8
"2011","OL6  9","OL6  9","Total",10564,5233,5331,10367,197,76,222.99,47.4
"2011","OL7  0","OL7  0","Total",5875,2960,2915,5846,29,20,230.50,25.5
"2011","OL7  9","OL7  9","Total",10888,5322,5566,10767,121,107,293.32,37.1
"2011","OL8  1","OL8  1","Total",10620,5338,5282,10540,80,57,168.38,63.1
"2011","OL8  2","OL8  2","Total",9498,4552,4946,9267,231,49,290.26,32.7
"2011","OL8  3","OL8  3","Total",10398,5002,5396,10398,0,46,399.68,26.0
"2011","OL8  4","OL8  4","Total",8530,4198,4332,8463,67,65,155.45,54.9
"2011","OL9  0","OL9  0","Total",8679,4220,4459,8679,0,73,189.16,45.9
"2011","OL9  6","OL9  6","Total",7380,3768,3612,7364,16,50,107.95,68.4
"2011","OL9  7","OL9  7","Total",6524,3239,3285,6415,109,27,90.68,71.9
"2011","OL9  8","OL9  8","Total",9571,4687,4884,9523,48,69,221.80,43.2
"2011","OL9  9","OL9  9","Total",9131,4568,4563,8997,134,102,468.70,19.5
"2011","OX1  1","OX1  1","Total",3252,1878,1374,2621,631,38,77.39,42.0
"2011","OX1  2","OX1  2","Total",1608,818,790,1035,573,36,42.07,38.2
"2011","OX1  3","OX1  3","Total",7422,4207,3215,532,6890,160,166.04,44.7
"2011","OX1  4","OX1  4","Total",7187,3746,3441,5273,1914,117,264.81,27.1
"2011","OX1  5","OX1  5","Total",6154,3037,3117,6071,83,170,1896.74,3.2
"2011","OX10 0","OX10 0","Total",5564,2657,2907,5473,91,98,485.41,11.5
"2011","OX10 6","OX10 6","Total",6815,3593,3222,6099,716,136,4477.21,1.5
"2011","OX10 7","OX10 7","Total",5203,2573,2630,5199,4,71,2740.05,1.9
"2011","OX10 8","OX10 8","Total",3214,1571,1643,3149,65,49,1340.72,2.4
"2011","OX10 9","OX10 9","Total",5567,2697,2870,5452,115,131,2430.75,2.3
"2011","OX11 0","OX11 0","Total",5434,2663,2771,5405,29,112,2069.14,2.6
"2011","OX11 7","OX11 7","Total",13108,6477,6631,12965,143,155,589.21,22.2
"2011","OX11 8","OX11 8","Total",8838,4347,4491,8838,0,86,187.24,47.2
"2011","OX11 9","OX11 9","Total",5722,2856,2866,5722,0,159,4928.03,1.2
"2011","OX12 0","OX12 0","Total",6155,3090,3065,6154,1,114,3092.30,2.0
"2011","OX12 7","OX12 7","Total",5301,2627,2674,5206,95,83,719.03,7.4
"2011","OX12 8","OX12 8","Total",4855,2330,2525,4778,77,114,6577.62,0.7
"2011","OX12 9","OX12 9","Total",8953,4398,4555,8831,122,189,7150.77,1.3
"2011","OX13 5","OX13 5","Total",4783,2373,2410,4780,3,159,4960.23,1.0
"2011","OX13 6","OX13 6","Total",8676,4623,4053,7739,937,182,3589.64,2.4
"2011","OX14 1","OX14 1","Total",10071,4967,5104,9958,113,222,305.62,33.0
"2011","OX14 2","OX14 2","Total",8243,4387,3856,7601,642,204,1033.81,8.0
"2011","OX14 3","OX14 3","Total",8304,4084,4220,8168,136,137,1115.26,7.4
"2011","OX14 4","OX14 4","Total",7883,3825,4058,7836,47,194,4903.00,1.6
"2011","OX14 5","OX14 5","Total",10009,4794,5215,9885,124,108,302.92,33.0
"2011","OX15 0","OX15 0","Total",2695,1293,1402,2651,44,59,2471.95,1.1
"2011","OX15 4","OX15 4","Total",6784,3362,3422,6550,234,204,3604.20,1.9
"2011","OX15 5","OX15 5","Total",5331,2585,2746,5226,105,172,7995.66,0.7
"2011","OX15 6","OX15 6","Total",3289,1599,1690,3237,52,99,5515.84,0.6
"2011","OX16 0","OX16 0","Total",11337,5527,5810,11295,42,91,214.10,53.0
"2011","OX16 1","OX16 1","Total",10518,5147,5371,10518,0,99,287.35,36.6
"2011","OX16 2","OX16 2","Total",2713,1357,1356,2674,39,20,317.91,8.5
"2011","OX16 3","OX16 3","Total",5002,2494,2508,4955,47,38,72.04,69.4
"2011","OX16 4","OX16 4","Total",3625,1775,1850,3625,0,18,385.21,9.4
"2011","OX16 5","OX16 5","Total",2612,1285,1327,2500,112,24,62.43,41.8
"2011","OX16 9","OX16 9","Total",11046,5233,5813,10758,288,146,766.80,14.4
"2011","OX17 1","OX17 1","Total",4308,2130,2178,4259,49,89,7434.49,0.6
"2011","OX17 2","OX17 2","Total",6553,3154,3399,6442,111,143,6081.52,1.1
"2011","OX17 3","OX17 3","Total",6114,2959,3155,6068,46,123,4881.93,1.3
"2011","OX18 1","OX18 1","Total",6826,3342,3484,6759,67,95,144.62,47.2
"2011","OX18 2","OX18 2","Total",5555,2755,2800,5522,33,113,6365.48,0.9
"2011","OX18 3","OX18 3","Total",9881,5310,4571,8694,1187,149,1552.05,6.4
"2011","OX18 4","OX18 4","Total",3039,1484,1555,2901,138,94,7850.61,0.4
"2011","OX2  0","OX2  0","Total",3949,2031,1918,3948,1,33,565.93,7.0
"2011","OX2  6","OX2  6","Total",10801,5413,5388,7925,2876,335,244.96,44.1
"2011","OX2  7","OX2  7","Total",9443,4630,4813,8252,1191,307,271.05,34.8
"2011","OX2  8","OX2  8","Total",6002,2874,3128,5983,19,160,1112.30,5.4
"2011","OX2  9","OX2  9","Total",9500,4634,4866,9172,328,242,2025.93,4.7
"2011","OX20 1","OX20 1","Total",4734,2212,2522,4680,54,86,4515.12,1.0
"2011","OX25 1","OX25 1","Total",2425,1643,782,1547,878,20,2419.33,1.0
"2011","OX25 2","OX25 2","Total",2507,1223,1284,2409,98,48,1383.21,1.8
"2011","OX25 3","OX25 3","Total",523,250,273,521,2,16,1005.58,0.5
"2011","OX25 4","OX25 4","Total",1278,639,639,1270,8,28,1185.66,1.1
"2011","OX25 5","OX25 5","Total",1787,884,903,1787,0,18,1372.80,1.3
"2011","OX25 6","OX25 6","Total",1099,533,566,1098,1,40,2390.50,0.5
"2011","OX26 1","OX26 1","Total",850,459,391,769,81,17,1319.45,0.6
"2011","OX26 2","OX26 2","Total",9155,4485,4670,9155,0,82,204.14,44.8
"2011","OX26 3","OX26 3","Total",7014,3444,3570,7014,0,68,123.45,56.8
"2011","OX26 4","OX26 4","Total",5846,2922,2924,5833,13,66,188.29,31.0
"2011","OX26 5","OX26 5","Total",1204,583,621,1204,0,16,1049.70,1.1
"2011","OX26 6","OX26 6","Total",9425,4756,4669,9076,349,71,857.15,11.0
"2011","OX27 0","OX27 0","Total",969,480,489,969,0,26,1135.86,0.9
"2011","OX27 7","OX27 7","Total",2117,1008,1109,2091,26,34,3038.74,0.7
"2011","OX27 8","OX27 8","Total",2883,1411,1472,2806,77,59,2918.52,1.0
"2011","OX27 9","OX27 9","Total",548,271,277,548,0,19,1731.60,0.3
"2011","OX28 1","OX28 1","Total",7888,3815,4073,7775,113,124,181.09,43.6
"2011","OX28 2","OX28 2","Total",854,398,456,824,30,18,33.73,25.3
"2011","OX28 3","OX28 3","Total",3087,1494,1593,3087,0,63,133.69,23.1
"2011","OX28 4","OX28 4","Total",1601,751,850,1594,7,20,51.71,31.0
"2011","OX28 5","OX28 5","Total",9222,4581,4641,9222,0,144,349.86,26.4
"2011","OX28 6","OX28 6","Total",4870,2301,2569,4801,69,59,172.24,28.3
"2011","OX29 0","OX29 0","Total",1409,684,725,1404,5,19,789.28,1.8
"2011","OX29 4","OX29 4","Total",5398,2604,2794,5352,46,96,2386.90,2.3
"2011","OX29 5","OX29 5","Total",1337,661,676,1337,0,54,2219.44,0.6
"2011","OX29 6","OX29 6","Total",2454,1201,1253,2437,17,68,3555.55,0.7
"2011","OX29 7","OX29 7","Total",3607,1813,1794,3525,82,73,3140.40,1.1
"2011","OX29 8","OX29 8","Total",6485,3177,3308,6412,73,144,2434.36,2.7
"2011","OX29 9","OX29 9","Total",2370,1151,1219,2312,58,65,3114.87,0.8
"2011","OX3  0","OX3  0","Total",11150,5300,5850,9023,2127,250,484.66,23.0
"2011","OX3  7","OX3  7","Total",11364,5415,5949,10721,643,155,273.08,41.6
"2011","OX3  8","OX3  8","Total",11994,5772,6222,11954,40,140,434.33,27.6
"2011","OX3  9","OX3  9","Total",8929,4268,4661,8855,74,142,2575.85,3.5
"2011","OX33 1","OX33 1","Total",7623,3743,3880,7500,123,191,5489.38,1.4
"2011","OX39 4","OX39 4","Total",6881,3351,3530,6851,30,120,3292.61,2.1
"2011","OX4  1","OX4  1","Total",12935,6412,6523,12192,743,220,213.46,60.6
"2011","OX4  2","OX4  2","Total",10267,5130,5137,9705,562,96,387.03,26.5
"2011","OX4  3","OX4  3","Total",12272,6122,6150,12192,80,105,192.99,63.6
"2011","OX4  4","OX4  4","Total",13154,6537,6617,12933,221,127,714.91,18.4
"2011","OX4  6","OX4  6","Total",7776,3800,3976,7730,46,38,160.42,48.5
"2011","OX4  7","OX4  7","Total",5568,2555,3013,5513,55,16,80.39,69.3
"2011","OX44 7","OX44 7","Total",5449,2688,2761,5447,2,113,5444.36,1.0
"2011","OX44 9","OX44 9","Total",2858,1402,1456,2832,26,52,3399.30,0.8
"2011","OX49 5","OX49 5","Total",4324,2055,2269,4279,45,122,6508.41,0.7
"2011","OX5  1","OX5  1","Total",12054,5970,6084,11782,272,193,2184.48,5.5
"2011","OX5  2","OX5  2","Total",8469,4158,4311,8417,52,150,4690.63,1.8
"2011","OX5  3","OX5  3","Total",2896,1417,1479,2856,40,75,4135.33,0.7
"2011","OX7  3","OX7  3","Total",5242,2560,2682,5241,1,162,7407.81,0.7
"2011","OX7  4","OX7  4","Total",1427,684,743,1394,33,33,4070.68,0.4
"2011","OX7  5","OX7  5","Total",7946,3818,4128,7814,132,138,5476.51,1.5
"2011","OX7  6","OX7  6","Total",6261,3069,3192,6038,223,161,9015.17,0.7
"2011","OX7  7","OX7  7","Total",1976,937,1039,1976,0,37,3079.20,0.6
"2011","OX9  2","OX9  2","Total",3491,1690,1801,3465,26,67,1291.62,2.7
"2011","OX9  3","OX9  3","Total",9297,4507,4790,9247,50,213,1700.15,5.5
"2011","OX9  7","OX9  7","Total",1034,511,523,1034,0,37,2281.06,0.5
"2011","PE1  1","PE1  1","Total",682,366,316,682,0,2,58.09,11.7
"2011","PE1  2","PE1  2","Total",11231,5833,5398,11108,123,113,218.72,51.3
"2011","PE1  3","PE1  3","Total",13722,6831,6891,13640,82,106,238.44,57.5
"2011","PE1  4","PE1  4","Total",14812,7318,7494,14695,117,126,338.31,43.8
"2011","PE1  5","PE1  5","Total",8726,4378,4348,8666,60,73,811.83,10.7
"2011","PE10 0","PE10 0","Total",10175,5026,5149,10081,94,210,15836.27,0.6
"2011","PE10 9","PE10 9","Total",11731,5608,6123,11525,206,219,1277.49,9.2
"2011","PE11 1","PE11 1","Total",8392,4078,4314,8330,62,91,240.21,34.9
"2011","PE11 2","PE11 2","Total",12978,6290,6688,12819,159,133,699.96,18.5
"2011","PE11 3","PE11 3","Total",13420,6574,6846,13307,113,150,13232.17,1.0
"2011","PE11 4","PE11 4","Total",8440,4126,4314,8344,96,83,9117.17,0.9
"2011","PE12 0","PE12 0","Total",6334,3150,3184,6332,2,70,9897.58,0.6
"2011","PE12 6","PE12 6","Total",9409,4655,4754,9384,25,115,10592.05,0.9
"2011","PE12 7","PE12 7","Total",8061,3888,4173,8001,60,67,827.00,9.7
"2011","PE12 8","PE12 8","Total",4577,2236,2341,4439,138,58,11696.89,0.4
"2011","PE12 9","PE12 9","Total",11401,5540,5861,11219,182,76,11078.55,1.0
"2011","PE13 1","PE13 1","Total",2998,1500,1498,2969,29,23,204.79,14.6
"2011","PE13 2","PE13 2","Total",8459,4088,4371,8271,188,63,286.55,29.5
"2011","PE13 3","PE13 3","Total",11161,5488,5673,11003,158,66,293.06,38.1
"2011","PE13 4","PE13 4","Total",6569,3234,3335,6563,6,78,7848.98,0.8
"2011","PE13 5","PE13 5","Total",5706,2815,2891,5691,15,51,5408.35,1.1
"2011","PE14 0","PE14 0","Total",5481,2653,2828,5397,84,45,6447.72,0.9
"2011","PE14 7","PE14 7","Total",5883,2962,2921,5822,61,64,6586.88,0.9
"2011","PE14 8","PE14 8","Total",5314,2632,2682,5259,55,46,4807.93,1.1
"2011","PE14 9","PE14 9","Total",4125,2002,2123,4107,18,46,7638.73,0.5
"2011","PE15 0","PE15 0","Total",9169,4706,4463,8715,454,82,16750.44,0.5
"2011","PE15 8","PE15 8","Total",10515,5163,5352,10445,70,80,567.98,18.5
"2011","PE15 9","PE15 9","Total",10231,4883,5348,10046,185,81,484.60,21.1
"2011","PE16 6","PE16 6","Total",10453,5163,5290,10414,39,100,6117.96,1.7
"2011","PE19 1","PE19 1","Total",6777,3327,3450,6739,38,79,339.32,20.0
"2011","PE19 2","PE19 2","Total",9972,5034,4938,9904,68,77,286.04,34.9
"2011","PE19 5","PE19 5","Total",6845,3371,3474,6801,44,142,10553.97,0.6
"2011","PE19 6","PE19 6","Total",7855,3887,3968,7791,64,117,7823.43,1.0
"2011","PE19 7","PE19 7","Total",5309,2660,2649,5266,43,102,232.41,22.8
"2011","PE19 8","PE19 8","Total",7210,3606,3604,7148,62,61,230.97,31.2
"2011","PE2  5","PE2  5","Total",14928,7226,7702,14917,11,143,488.83,30.5
"2011","PE2  6","PE2  6","Total",2716,1332,1384,2716,0,61,412.32,6.6
"2011","PE2  7","PE2  7","Total",3394,1676,1718,3284,110,57,343.84,9.9
"2011","PE2  8","PE2  8","Total",13322,6536,6786,13238,84,98,1201.42,11.1
"2011","PE2  9","PE2  9","Total",10180,5100,5080,10165,15,75,326.93,31.1
"2011","PE20 1","PE20 1","Total",6670,3208,3462,6595,75,75,5306.38,1.3
"2011","PE20 2","PE20 2","Total",2942,1463,1479,2942,0,29,4478.94,0.7
"2011","PE20 3","PE20 3","Total",4374,2165,2209,4374,0,52,8368.41,0.5
"2011","PE21 0","PE21 0","Total",9653,4579,5074,9571,82,92,1413.87,6.8
"2011","PE21 6","PE21 6","Total",3135,1559,1576,3074,61,28,117.82,26.6
"2011","PE21 7","PE21 7","Total",8925,4338,4587,8814,111,101,1976.28,4.5
"2011","PE21 8","PE21 8","Total",12216,5959,6257,12104,112,69,350.37,34.9
"2011","PE21 9","PE21 9","Total",8858,4200,4658,8751,107,115,972.24,9.1
"2011","PE22 0","PE22 0","Total",6084,3212,2872,5753,331,80,8132.75,0.7
"2011","PE22 7","PE22 7","Total",3394,1690,1704,3394,0,55,12577.29,0.3
"2011","PE22 8","PE22 8","Total",4022,1989,2033,4000,22,41,9722.72,0.4
"2011","PE22 9","PE22 9","Total",3419,1668,1751,3397,22,43,5157.78,0.7
"2011","PE23 4","PE23 4","Total",2586,1261,1325,2540,46,39,8648.39,0.3
"2011","PE23 5","PE23 5","Total",5921,2869,3052,5758,163,63,7251.44,0.8
"2011","PE24 4","PE24 4","Total",4133,2017,2116,4092,41,39,8770.18,0.5
"2011","PE24 5","PE24 5","Total",7697,3762,3935,7632,65,54,6153.69,1.3
"2011","PE25 1","PE25 1","Total",7225,3503,3722,6719,506,50,1200.11,6.0
"2011","PE25 2","PE25 2","Total",8823,4254,4569,8620,203,36,522.66,16.9
"2011","PE25 3","PE25 3","Total",5590,2639,2951,5329,261,73,427.37,13.1
"2011","PE26 1","PE26 1","Total",5640,2792,2848,5618,22,64,702.77,8.0
"2011","PE26 2","PE26 2","Total",6305,3153,3152,6208,97,99,9575.77,0.7
"2011","PE27 3","PE27 3","Total",7648,3774,3874,7648,0,126,417.22,18.3
"2011","PE27 4","PE27 4","Total",2517,1263,1254,2515,2,47,1179.50,2.1
"2011","PE27 5","PE27 5","Total",5225,2611,2614,5191,34,56,649.72,8.0
"2011","PE27 6","PE27 6","Total",4625,2278,2347,4619,6,75,226.30,20.4
"2011","PE28 0","PE28 0","Total",6509,3792,2717,5308,1201,141,9056.99,0.7
"2011","PE28 2","PE28 2","Total",9050,4481,4569,9050,0,172,9685.36,0.9
"2011","PE28 3","PE28 3","Total",9544,4793,4751,9470,74,166,7549.57,1.3
"2011","PE28 4","PE28 4","Total",8571,4273,4298,8177,394,183,5268.86,1.6
"2011","PE28 5","PE28 5","Total",7553,3780,3773,7453,100,109,14335.56,0.5
"2011","PE28 9","PE28 9","Total",6347,3059,3288,6342,5,130,2954.06,2.1
"2011","PE29 1","PE29 1","Total",12110,5937,6173,11951,159,87,391.18,31.0
"2011","PE29 2","PE29 2","Total",6711,3275,3436,6711,0,114,1984.13,3.4
"2011","PE29 3","PE29 3","Total",1838,955,883,1816,22,14,84.17,21.8
"2011","PE29 6","PE29 6","Total",5529,2737,2792,5525,4,100,267.93,20.6
"2011","PE29 7","PE29 7","Total",3594,1771,1823,3528,66,22,169.68,21.2
"2011","PE3  6","PE3  6","Total",5876,2865,3011,5784,92,121,462.94,12.7
"2011","PE3  7","PE3  7","Total",6322,3146,3176,6095,227,52,170.81,37.0
"2011","PE3  8","PE3  8","Total",6927,3377,3550,6927,0,61,247.57,28.0
"2011","PE3  9","PE3  9","Total",9772,4783,4989,9584,188,161,318.56,30.7
"2011","PE30 1","PE30 1","Total",1912,939,973,1857,55,9,69.02,27.7
"2011","PE30 2","PE30 2","Total",7060,3469,3591,6988,72,46,485.37,14.5
"2011","PE30 3","PE30 3","Total",14373,6973,7400,14179,194,238,3111.61,4.6
"2011","PE30 4","PE30 4","Total",12918,6261,6657,12800,118,98,472.83,27.3
"2011","PE30 5","PE30 5","Total",7726,3865,3861,7631,95,49,290.83,26.6
"2011","PE31 6","PE31 6","Total",7919,3753,4166,7884,35,97,14072.58,0.6
"2011","PE31 7","PE31 7","Total",7320,3430,3890,7176,144,75,3712.12,2.0
"2011","PE31 8","PE31 8","Total",4764,2299,2465,4710,54,96,16513.87,0.3
"2011","PE32 1","PE32 1","Total",8945,4329,4616,8916,29,134,15812.45,0.6
"2011","PE32 2","PE32 2","Total",6349,3150,3199,6296,53,109,17384.25,0.4
"2011","PE33 0","PE33 0","Total",7744,3761,3983,7657,87,96,7464.80,1.0
"2011","PE33 9","PE33 9","Total",8201,4342,3859,7397,804,140,13849.65,0.6
"2011","PE34 3","PE34 3","Total",5421,2695,2726,5418,3,57,6630.52,0.8
"2011","PE34 4","PE34 4","Total",8963,4384,4579,8926,37,91,9571.51,0.9
"2011","PE36 5","PE36 5","Total",3717,1722,1995,3624,93,44,3680.79,1.0
"2011","PE36 6","PE36 6","Total",2812,1344,1468,2713,99,74,3472.91,0.8
"2011","PE37 7","PE37 7","Total",6803,3167,3636,6546,257,52,2946.43,2.3
"2011","PE37 8","PE37 8","Total",3421,1661,1760,3409,12,34,7341.48,0.5
"2011","PE38 0","PE38 0","Total",4815,2437,2378,4815,0,68,11715.12,0.4
"2011","PE38 9","PE38 9","Total",9994,4752,5242,9871,123,95,520.36,19.2
"2011","PE4  5","PE4  5","Total",5942,2937,3005,5931,11,97,281.77,21.1
"2011","PE4  6","PE4  6","Total",11122,5373,5749,11041,81,126,399.89,27.8
"2011","PE4  7","PE4  7","Total",11297,5527,5770,11291,6,98,408.89,27.6
"2011","PE5  7","PE5  7","Total",1589,775,814,1589,0,55,2871.48,0.6
"2011","PE6  0","PE6  0","Total",6612,3244,3368,6586,26,59,14253.82,0.5
"2011","PE6  7","PE6  7","Total",9597,4700,4897,9556,41,131,7137.13,1.3
"2011","PE6  8","PE6  8","Total",13059,6272,6787,12972,87,251,2488.73,5.2
"2011","PE6  9","PE6  9","Total",6285,3085,3200,6285,0,151,4312.38,1.5
"2011","PE7  0","PE7  0","Total",177,82,95,177,0,2,12.12,14.6
"2011","PE7  1","PE7  1","Total",12745,6136,6609,12645,100,135,1998.78,6.4
"2011","PE7  2","PE7  2","Total",2826,1442,1384,2826,0,37,4240.68,0.7
"2011","PE7  3","PE7  3","Total",16091,7906,8185,16047,44,215,10511.19,1.5
"2011","PE7  8","PE7  8","Total",10472,5181,5291,10398,74,85,1278.41,8.2
"2011","PE8  4","PE8  4","Total",5735,2862,2873,4834,901,167,901.03,6.4
"2011","PE8  5","PE8  5","Total",3598,1801,1797,3500,98,126,14667.10,0.2
"2011","PE8  6","PE8  6","Total",8167,4224,3943,7678,489,149,9124.64,0.9
"2011","PE9  1","PE9  1","Total",9405,4424,4981,9320,85,115,285.06,33.0
"2011","PE9  2","PE9  2","Total",9697,4617,5080,9485,212,202,485.53,20.0
"2011","PE9  3","PE9  3","Total",6028,2977,3051,5937,91,172,9826.56,0.6
"2011","PE9  4","PE9  4","Total",6059,2950,3109,5951,108,145,9653.00,0.6
"2011","PL1  1","PL1  1","Total",784,410,374,596,188,4,41.01,19.1
"2011","PL1  2","PL1  2","Total",2326,1287,1039,2157,169,7,50.23,46.3
"2011","PL1  3","PL1  3","Total",4998,2724,2274,4873,125,14,131.29,38.1
"2011","PL1  4","PL1  4","Total",5762,2936,2826,5621,141,38,189.92,30.3
"2011","PL1  5","PL1  5","Total",8828,4654,4174,8666,162,68,120.47,73.3
"2011","PL10 1","PL10 1","Total",3656,1771,1885,3656,0,43,1796.00,2.0
"2011","PL11 2","PL11 2","Total",7894,3799,4095,7872,22,75,473.67,16.7
"2011","PL11 3","PL11 3","Total",2465,1181,1284,2465,0,26,4013.90,0.6
"2011","PL12 4","PL12 4","Total",10571,5106,5465,10542,29,134,1645.06,6.4
"2011","PL12 5","PL12 5","Total",2453,1230,1223,2453,0,33,3482.16,0.7
"2011","PL12 6","PL12 6","Total",8763,4307,4456,8763,0,117,5553.22,1.6
"2011","PL13 1","PL13 1","Total",4225,2048,2177,4169,56,41,2465.15,1.7
"2011","PL13 2","PL13 2","Total",5213,2540,2673,5213,0,57,6223.85,0.8
"2011","PL14 3","PL14 3","Total",8347,4001,4346,8347,0,107,7337.67,1.1
"2011","PL14 4","PL14 4","Total",5527,2708,2819,5525,2,56,6602.41,0.8
"2011","PL14 5","PL14 5","Total",5600,2744,2856,5600,0,70,4098.03,1.4
"2011","PL14 6","PL14 6","Total",3492,1665,1827,3492,0,44,8364.74,0.4
"2011","PL15 7","PL15 7","Total",6337,3027,3310,6111,226,95,13595.75,0.5
"2011","PL15 8","PL15 8","Total",7078,3508,3570,6956,122,84,13411.46,0.5
"2011","PL15 9","PL15 9","Total",6492,3148,3344,6337,155,79,9950.46,0.7
"2011","PL16 0","PL16 0","Total",1753,878,875,1753,0,34,4470.85,0.4
"2011","PL17 7","PL17 7","Total",5788,2903,2885,5788,0,61,3809.92,1.5
"2011","PL17 8","PL17 8","Total",4234,2102,2132,4154,80,57,4524.16,0.9
"2011","PL18 9","PL18 9","Total",4810,2331,2479,4810,0,104,1474.83,3.3
"2011","PL19 0","PL19 0","Total",3003,1481,1522,2746,257,67,4180.93,0.7
"2011","PL19 8","PL19 8","Total",6185,2916,3269,6022,163,112,5776.57,1.1
"2011","PL19 9","PL19 9","Total",7235,3394,3841,7116,119,154,8553.24,0.8
"2011","PL2  1","PL2  1","Total",10097,5157,4940,10042,55,69,100.91,100.1
"2011","PL2  2","PL2  2","Total",10661,5269,5392,10441,220,48,311.80,34.2
"2011","PL2  3","PL2  3","Total",10700,5199,5501,10656,44,95,261.24,41.0
"2011","PL20 6","PL20 6","Total",5334,2771,2563,4703,631,121,28251.39,0.2
"2011","PL20 7","PL20 7","Total",6747,3261,3486,6664,83,103,4247.89,1.6
"2011","PL21 0","PL21 0","Total",9481,4560,4921,9342,139,196,4899.77,1.9
"2011","PL21 9","PL21 9","Total",7908,3840,4068,7864,44,159,6770.78,1.2
"2011","PL22 0","PL22 0","Total",3695,1752,1943,3568,127,37,6827.87,0.5
"2011","PL23 1","PL23 1","Total",3519,1672,1847,3430,89,68,3135.18,1.1
"2011","PL24 2","PL24 2","Total",10156,4876,5280,9854,302,73,1663.03,6.1
"2011","PL25 3","PL25 3","Total",10992,5313,5679,10869,123,111,769.44,14.3
"2011","PL25 4","PL25 4","Total",8871,4219,4652,8487,384,79,295.51,30.0
"2011","PL25 5","PL25 5","Total",5688,2785,2903,5537,151,59,1163.97,4.9
"2011","PL26 6","PL26 6","Total",5142,2434,2708,4961,181,61,5804.04,0.9
"2011","PL26 7","PL26 7","Total",9609,4703,4906,9570,39,82,5118.79,1.9
"2011","PL26 8","PL26 8","Total",11922,5939,5983,11845,77,79,6711.26,1.8
"2011","PL27 6","PL27 6","Total",5364,2540,2824,5209,155,96,5444.17,1.0
"2011","PL27 7","PL27 7","Total",6863,3226,3637,6640,223,82,7982.53,0.9
"2011","PL28 8","PL28 8","Total",4434,2114,2320,4324,110,39,2954.75,1.5
"2011","PL29 3","PL29 3","Total",1029,505,524,972,57,10,1529.60,0.7
"2011","PL3  4","PL3  4","Total",9451,4640,4811,9241,210,117,198.25,47.7
"2011","PL3  5","PL3  5","Total",9245,4488,4757,9032,213,165,219.28,42.2
"2011","PL3  6","PL3  6","Total",12255,5878,6377,12222,33,64,281.15,43.6
"2011","PL30 3","PL30 3","Total",3597,1754,1843,3491,106,56,8831.51,0.4
"2011","PL30 4","PL30 4","Total",2576,1247,1329,2557,19,35,12977.92,0.2
"2011","PL30 5","PL30 5","Total",4384,2158,2226,4308,76,34,10233.84,0.4
"2011","PL31 1","PL31 1","Total",8199,3942,4257,8037,162,95,752.75,10.9
"2011","PL31 2","PL31 2","Total",6537,3200,3337,6438,99,62,587.70,11.1
"2011","PL32 9","PL32 9","Total",4326,2091,2235,4257,69,41,9111.28,0.5
"2011","PL33 9","PL33 9","Total",1647,803,844,1647,0,16,272.02,6.1
"2011","PL34 0","PL34 0","Total",1782,859,923,1712,70,11,1972.99,0.9
"2011","PL35 0","PL35 0","Total",940,455,485,935,5,9,2103.32,0.4
"2011","PL4  0","PL4  0","Total",2717,1368,1349,2717,0,9,104.38,26.0
"2011","PL4  6","PL4  6","Total",6582,3624,2958,5836,746,65,67.20,97.9
"2011","PL4  7","PL4  7","Total",9078,4702,4376,8778,300,65,129.68,70.0
"2011","PL4  8","PL4  8","Total",10179,5368,4811,9108,1071,85,71.82,141.7
"2011","PL4  9","PL4  9","Total",7908,4069,3839,7788,120,48,134.03,59.0
"2011","PL5  1","PL5  1","Total",12269,5987,6282,12258,11,62,268.77,45.6
"2011","PL5  2","PL5  2","Total",9913,4816,5097,9849,64,36,420.97,23.5
"2011","PL5  3","PL5  3","Total",11299,5366,5933,11197,102,65,280.05,40.3
"2011","PL5  4","PL5  4","Total",9435,4596,4839,9370,65,66,317.40,29.7
"2011","PL6  5","PL6  5","Total",13480,6487,6993,13397,83,103,451.71,29.8
"2011","PL6  6","PL6  6","Total",9179,4367,4812,9140,39,45,303.96,30.2
"2011","PL6  7","PL6  7","Total",8442,4223,4219,8169,273,84,2529.51,3.3
"2011","PL6  8","PL6  8","Total",10099,4834,5265,9616,483,75,655.77,15.4
"2011","PL7  1","PL7  1","Total",8929,4260,4669,8751,178,78,371.32,24.0
"2011","PL7  2","PL7  2","Total",10781,5276,5505,10727,54,81,277.45,38.9
"2011","PL7  4","PL7  4","Total",9188,4356,4832,8982,206,98,430.05,21.4
"2011","PL7  5","PL7  5","Total",2576,1283,1293,2574,2,23,6366.66,0.4
"2011","PL8  1","PL8  1","Total",2433,1192,1241,2422,11,82,3453.51,0.7
"2011","PL8  2","PL8  2","Total",3301,1559,1742,3259,42,58,2800.41,1.2
"2011","PL9  0","PL9  0","Total",2740,1309,1431,2735,5,37,1529.19,1.8
"2011","PL9  7","PL9  7","Total",5355,2607,2748,5323,32,66,542.23,9.9
"2011","PL9  8","PL9  8","Total",7964,3754,4210,7848,116,93,481.27,16.5
"2011","PL9  9","PL9  9","Total",11902,5754,6148,11861,41,112,726.86,16.4
"2011","PO1  1","PO1  1","Total",4138,2098,2040,4137,1,15,57.82,71.6
"2011","PO1  2","PO1  2","Total",4164,2160,2004,2697,1467,123,75.39,55.2
"2011","PO1  3","PO1  3","Total",5858,3326,2532,5142,716,48,173.90,33.7
"2011","PO1  4","PO1  4","Total",4842,2340,2502,4825,17,13,65.56,73.9
"2011","PO1  5","PO1  5","Total",9839,4996,4843,9805,34,57,93.95,104.7
"2011","PO10 7","PO10 7","Total",9492,4522,4970,9278,214,148,482.20,19.7
"2011","PO10 8","PO10 8","Total",8868,4375,4493,8366,502,126,1862.58,4.8
"2011","PO11 0","PO11 0","Total",7863,3805,4058,7602,261,99,1192.63,6.6
"2011","PO11 9","PO11 9","Total",9516,4585,4931,9330,186,61,396.84,24.0
"2011","PO12 1","PO12 1","Total",8612,4328,4284,8567,45,42,149.86,57.5
"2011","PO12 2","PO12 2","Total",9715,4713,5002,9319,396,178,438.32,22.2
"2011","PO12 3","PO12 3","Total",12097,6004,6093,11928,169,100,315.11,38.4
"2011","PO12 4","PO12 4","Total",17422,8736,8686,17355,67,144,410.77,42.4
"2011","PO13 0","PO13 0","Total",16151,7903,8248,16148,3,80,527.97,30.6
"2011","PO13 8","PO13 8","Total",7299,3555,3744,7299,0,77,317.55,23.0
"2011","PO13 9","PO13 9","Total",11326,5497,5829,11150,176,125,372.51,30.4
"2011","PO14 1","PO14 1","Total",7734,3751,3983,7599,135,56,333.12,23.2
"2011","PO14 2","PO14 2","Total",7808,3731,4077,7711,97,93,659.27,11.8
"2011","PO14 3","PO14 3","Total",8589,4106,4483,8485,104,182,444.26,19.3
"2011","PO14 4","PO14 4","Total",8046,3983,4063,8001,45,141,976.74,8.2
"2011","PO15 5","PO15 5","Total",7275,3547,3728,7205,70,89,400.13,18.2
"2011","PO15 6","PO15 6","Total",8357,4053,4304,8308,49,84,607.61,13.8
"2011","PO15 7","PO15 7","Total",7252,3676,3576,7252,0,87,746.02,9.7
"2011","PO16 0","PO16 0","Total",5642,2790,2852,5591,51,44,178.37,31.6
"2011","PO16 7","PO16 7","Total",7726,3743,3983,7446,280,112,223.98,34.5
"2011","PO16 8","PO16 8","Total",10727,5314,5413,10626,101,126,611.14,17.6
"2011","PO16 9","PO16 9","Total",8561,4170,4391,8561,0,84,268.30,31.9
"2011","PO17 5","PO17 5","Total",4654,2333,2321,4519,135,63,2116.96,2.2
"2011","PO17 6","PO17 6","Total",1873,924,949,1685,188,43,2275.03,0.8
"2011","PO18 0","PO18 0","Total",4600,2153,2447,4460,140,97,10789.72,0.4
"2011","PO18 8","PO18 8","Total",6691,3255,3436,6544,147,168,2859.13,2.3
"2011","PO18 9","PO18 9","Total",1726,853,873,1702,24,57,5325.93,0.3
"2011","PO19 1","PO19 1","Total",1639,740,899,1359,280,44,81.87,20.0
"2011","PO19 3","PO19 3","Total",6238,2916,3322,6156,82,94,458.42,13.6
"2011","PO19 5","PO19 5","Total",2378,1129,1249,2378,0,58,137.70,17.3
"2011","PO19 6","PO19 6","Total",6918,3231,3687,6550,368,80,227.96,30.3
"2011","PO19 7","PO19 7","Total",7595,3651,3944,7565,30,82,155.97,48.7
"2011","PO19 8","PO19 8","Total",5477,2569,2908,5398,79,74,613.69,8.9
"2011","PO2  0","PO2  0","Total",13069,6482,6587,13014,55,56,133.29,98.0
"2011","PO2  7","PO2  7","Total",12867,6355,6512,12849,18,58,117.97,109.1
"2011","PO2  8","PO2  8","Total",8083,3946,4137,8061,22,20,158.99,50.8
"2011","PO2  9","PO2  9","Total",8024,3895,4129,7989,35,40,142.16,56.4
"2011","PO20 0","PO20 0","Total",8566,4011,4555,8382,184,49,348.26,24.6
"2011","PO20 1","PO20 1","Total",2458,1187,1271,2445,13,46,1482.75,1.7
"2011","PO20 2","PO20 2","Total",3676,1755,1921,3585,91,53,1864.53,2.0
"2011","PO20 3","PO20 3","Total",4321,2090,2231,4264,57,74,710.08,6.1
"2011","PO20 7","PO20 7","Total",3571,1769,1802,3527,44,98,3515.73,1.0
"2011","PO20 8","PO20 8","Total",7358,3449,3909,7180,178,111,1398.51,5.3
"2011","PO20 9","PO20 9","Total",2171,1039,1132,2079,92,28,618.22,3.5
"2011","PO21 1","PO21 1","Total",6178,2994,3184,5228,950,37,118.40,52.2
"2011","PO21 2","PO21 2","Total",9933,4800,5133,9139,794,72,149.98,66.2
"2011","PO21 3","PO21 3","Total",8015,3827,4188,7976,39,63,966.38,8.3
"2011","PO21 4","PO21 4","Total",7269,3371,3898,7241,28,72,343.43,21.2
"2011","PO21 5","PO21 5","Total",8907,4262,4645,8858,49,57,393.69,22.6
"2011","PO22 0","PO22 0","Total",3808,1842,1966,3748,60,63,598.20,6.4
"2011","PO22 6","PO22 6","Total",5855,2782,3073,5832,23,63,347.93,16.8
"2011","PO22 7","PO22 7","Total",5604,2577,3027,5535,69,85,205.26,27.3
"2011","PO22 8","PO22 8","Total",5714,2716,2998,5641,73,52,402.98,14.2
"2011","PO22 9","PO22 9","Total",7369,3559,3810,7357,12,50,855.82,8.6
"2011","PO3  5","PO3  5","Total",7618,3768,3850,7618,0,69,351.48,21.7
"2011","PO3  6","PO3  6","Total",11668,5805,5863,11446,222,91,217.09,53.7
"2011","PO30 1","PO30 1","Total",7158,3431,3727,7049,109,89,591.51,12.1
"2011","PO30 2","PO30 2","Total",5310,2567,2743,5158,152,36,416.92,12.7
"2011","PO30 3","PO30 3","Total",2331,1126,1205,2285,46,41,6755.73,0.3
"2011","PO30 4","PO30 4","Total",3094,1483,1611,3070,24,43,5715.62,0.5
"2011","PO30 5","PO30 5","Total",12416,6913,5503,10717,1699,110,1349.82,9.2
"2011","PO31 7","PO31 7","Total",8632,4208,4424,8522,110,94,172.65,50.0
"2011","PO31 8","PO31 8","Total",5766,2772,2994,5707,59,89,1072.44,5.4
"2011","PO32 6","PO32 6","Total",8101,3902,4199,7976,125,60,1131.56,7.2
"2011","PO33 1","PO33 1","Total",8636,4169,4467,8475,161,66,733.70,11.8
"2011","PO33 2","PO33 2","Total",7663,3720,3943,7471,192,63,141.95,54.0
"2011","PO33 3","PO33 3","Total",9379,4475,4904,9180,199,130,584.98,16.0
"2011","PO33 4","PO33 4","Total",5329,2523,2806,5072,257,75,3469.73,1.5
"2011","PO34 5","PO34 5","Total",2083,985,1098,2077,6,38,278.22,7.5
"2011","PO35 5","PO35 5","Total",3688,1696,1992,3472,216,59,912.78,4.0
"2011","PO36 0","PO36 0","Total",4656,2272,2384,4640,16,57,3028.54,1.5
"2011","PO36 8","PO36 8","Total",5241,2545,2696,5038,203,57,308.55,17.0
"2011","PO36 9","PO36 9","Total",7061,3328,3733,6901,160,45,358.91,19.7
"2011","PO37 6","PO37 6","Total",3428,1678,1750,3131,297,33,510.17,6.7
"2011","PO37 7","PO37 7","Total",5644,2736,2908,5552,92,85,262.02,21.5
"2011","PO38 1","PO38 1","Total",5976,2888,3088,5792,184,54,819.79,7.3
"2011","PO38 2","PO38 2","Total",2721,1338,1383,2718,3,45,2182.20,1.2
"2011","PO38 3","PO38 3","Total",3850,1871,1979,3847,3,36,3115.13,1.2
"2011","PO39 0","PO39 0","Total",2645,1263,1382,2473,172,25,529.21,5.0
"2011","PO4  0","PO4  0","Total",14280,7538,6742,14097,183,162,96.20,148.4
"2011","PO4  8","PO4  8","Total",14436,7207,7229,13720,716,118,301.85,47.8
"2011","PO4  9","PO4  9","Total",15353,7553,7800,15272,81,147,229.64,66.9
"2011","PO40 9","PO40 9","Total",5436,2557,2879,5371,65,54,1311.13,4.1
"2011","PO41 0","PO41 0","Total",2021,978,1043,2019,2,35,2262.84,0.9
"2011","PO5  1","PO5  1","Total",9291,4974,4317,9253,38,88,64.75,143.5
"2011","PO5  2","PO5  2","Total",7459,3952,3507,7250,209,74,122.89,60.7
"2011","PO5  3","PO5  3","Total",5735,3177,2558,5158,577,60,39.28,146.0
"2011","PO5  4","PO5  4","Total",7438,3656,3782,7124,314,40,60.56,122.8
"2011","PO6  1","PO6  1","Total",8542,4203,4339,8415,127,112,482.08,17.7
"2011","PO6  2","PO6  2","Total",11472,5609,5863,11378,94,122,258.85,44.3
"2011","PO6  3","PO6  3","Total",9893,4762,5131,9818,75,43,362.86,27.3
"2011","PO6  4","PO6  4","Total",10656,5236,5420,10653,3,50,424.71,25.1
"2011","PO7  4","PO7  4","Total",1165,554,611,1165,0,45,2716.78,0.4
"2011","PO7  5","PO7  5","Total",11576,5694,5882,11522,54,125,2305.29,5.0
"2011","PO7  6","PO7  6","Total",9878,4823,5055,9817,61,122,1279.79,7.7
"2011","PO7  7","PO7  7","Total",9057,4380,4677,8890,167,91,248.59,36.4
"2011","PO7  8","PO7  8","Total",8496,4148,4348,8467,29,80,339.68,25.0
"2011","PO8  0","PO8  0","Total",9625,4713,4912,9583,42,140,3633.00,2.6
"2011","PO8  8","PO8  8","Total",9478,4606,4872,9413,65,80,234.61,40.4
"2011","PO8  9","PO8  9","Total",14737,7187,7550,14675,62,153,506.60,29.1
"2011","PO9  1","PO9  1","Total",5287,2611,2676,5220,67,60,329.80,16.0
"2011","PO9  2","PO9  2","Total",10430,5042,5388,10351,79,97,550.35,19.0
"2011","PO9  3","PO9  3","Total",10081,4879,5202,9998,83,84,453.79,22.2
"2011","PO9  4","PO9  4","Total",10577,5087,5490,10542,35,35,361.06,29.3
"2011","PO9  5","PO9  5","Total",9451,4631,4820,9428,23,26,338.27,27.9
"2011","PO9  6","PO9  6","Total",2863,1382,1481,2826,37,98,2394.14,1.2
"2011","PR1  0","PR1  0","Total",9635,4658,4977,9575,60,185,626.74,15.4
"2011","PR1  1","PR1  1","Total",3702,1921,1781,2627,1075,57,55.11,67.2
"2011","PR1  2","PR1  2","Total",1592,826,766,805,787,26,45.57,34.9
"2011","PR1  3","PR1  3","Total",3436,1966,1470,3373,63,23,85.31,40.3
"2011","PR1  4","PR1  4","Total",8826,4435,4391,8815,11,37,299.24,29.5
"2011","PR1  5","PR1  5","Total",9090,4893,4197,8506,584,47,586.72,15.5
"2011","PR1  6","PR1  6","Total",10975,5519,5456,10865,110,60,205.85,53.3
"2011","PR1  7","PR1  7","Total",6455,3299,3156,4973,1482,78,85.17,75.8
"2011","PR1  8","PR1  8","Total",5544,2922,2622,5497,47,50,99.33,55.8
"2011","PR1  9","PR1  9","Total",12294,5968,6326,12213,81,132,473.66,26.0
"2011","PR2  1","PR2  1","Total",15065,7422,7643,14909,156,137,760.84,19.8
"2011","PR2  2","PR2  2","Total",8437,4252,4185,7763,674,60,234.24,36.0
"2011","PR2  3","PR2  3","Total",14910,7207,7703,14783,127,220,393.80,37.9
"2011","PR2  5","PR2  5","Total",2855,1416,1439,2829,26,51,1309.69,2.2
"2011","PR2  6","PR2  6","Total",15644,7699,7945,15529,115,104,423.67,36.9
"2011","PR2  7","PR2  7","Total",4296,2081,2215,4213,83,65,191.42,22.4
"2011","PR2  8","PR2  8","Total",6844,3393,3451,6678,166,93,256.59,26.7
"2011","PR2  9","PR2  9","Total",11157,5442,5715,10935,222,187,479.90,23.2
"2011","PR25 1","PR25 1","Total",8635,4186,4449,8557,78,72,344.49,25.1
"2011","PR25 2","PR25 2","Total",5154,2496,2658,5144,10,39,131.34,39.2
"2011","PR25 3","PR25 3","Total",6738,3331,3407,6688,50,90,258.48,26.1
"2011","PR25 4","PR25 4","Total",5998,2886,3112,5970,28,46,435.65,13.8
"2011","PR25 5","PR25 5","Total",4256,2077,2179,4211,45,53,365.50,11.6
"2011","PR26 6","PR26 6","Total",2928,1489,1439,2898,30,29,737.26,4.0
"2011","PR26 7","PR26 7","Total",6402,3167,3235,6312,90,72,342.08,18.7
"2011","PR26 8","PR26 8","Total",2672,2261,411,790,1882,14,753.30,3.5
"2011","PR26 9","PR26 9","Total",3586,1749,1837,3541,45,58,1978.02,1.8
"2011","PR3  0","PR3  0","Total",7442,3686,3756,7003,439,162,8999.43,0.8
"2011","PR3  1","PR3  1","Total",10282,4987,5295,10194,88,147,7475.79,1.4
"2011","PR3  2","PR3  2","Total",5557,2701,2856,5426,131,116,10957.59,0.5
"2011","PR3  3","PR3  3","Total",9023,4361,4662,8959,64,132,2652.88,3.4
"2011","PR3  5","PR3  5","Total",3021,1465,1556,3021,0,70,1683.16,1.8
"2011","PR3  6","PR3  6","Total",2646,1333,1313,2621,25,35,4452.41,0.6
"2011","PR4  0","PR4  0","Total",7190,3596,3594,7170,20,135,5137.44,1.4
"2011","PR4  1","PR4  1","Total",9474,4555,4919,9406,68,110,1754.30,5.4
"2011","PR4  2","PR4  2","Total",8567,4426,4141,7904,663,123,840.15,10.2
"2011","PR4  3","PR4  3","Total",8357,4060,4297,8274,83,122,6060.90,1.4
"2011","PR4  4","PR4  4","Total",6152,3068,3084,6117,35,120,1756.58,3.5
"2011","PR4  5","PR4  5","Total",8162,3952,4210,8080,82,136,2105.73,3.9
"2011","PR4  6","PR4  6","Total",9693,4812,4881,9669,24,113,4102.03,2.4
"2011","PR5  0","PR5  0","Total",5569,2691,2878,5496,73,77,2633.76,2.1
"2011","PR5  4","PR5  4","Total",11152,5551,5601,11110,42,132,818.65,13.6
"2011","PR5  5","PR5  5","Total",10061,4991,5070,10000,61,79,320.37,31.4
"2011","PR5  6","PR5  6","Total",9276,4432,4844,9166,110,62,488.43,19.0
"2011","PR5  8","PR5  8","Total",5145,2549,2596,4983,162,39,147.50,34.9
"2011","PR6  0","PR6  0","Total",10257,4966,5291,10150,107,56,378.30,27.1
"2011","PR6  7","PR6  7","Total",10188,5119,5069,10125,63,148,557.50,18.3
"2011","PR6  8","PR6  8","Total",6679,3248,3431,6618,61,134,3753.57,1.8
"2011","PR6  9","PR6  9","Total",7567,3717,3850,7489,78,100,3114.81,2.4
"2011","PR7  1","PR7  1","Total",6640,3274,3366,6535,105,83,309.53,21.5
"2011","PR7  2","PR7  2","Total",9799,4827,4972,9744,55,79,339.84,28.8
"2011","PR7  3","PR7  3","Total",8608,4273,4335,8603,5,82,453.70,19.0
"2011","PR7  4","PR7  4","Total",7003,3473,3530,6959,44,54,965.98,7.2
"2011","PR7  5","PR7  5","Total",10475,5166,5309,10394,81,121,2385.38,4.4
"2011","PR7  6","PR7  6","Total",8749,4276,4473,8684,65,131,1238.04,7.1
"2011","PR7  7","PR7  7","Total",4178,2096,2082,4103,75,49,549.09,7.6
"2011","PR8  1","PR8  1","Total",3057,1468,1589,2895,162,22,82.65,37.0
"2011","PR8  2","PR8  2","Total",8916,4142,4774,8465,451,175,1245.11,7.2
"2011","PR8  3","PR8  3","Total",12059,5729,6330,12026,33,165,639.11,18.9
"2011","PR8  4","PR8  4","Total",11186,5379,5807,11125,61,164,389.44,28.7
"2011","PR8  5","PR8  5","Total",6212,2998,3214,6160,52,55,662.69,9.4
"2011","PR8  6","PR8  6","Total",12188,5981,6207,11931,257,149,398.95,30.6
"2011","PR9  0","PR9  0","Total",7211,3600,3611,6782,429,39,574.04,12.6
"2011","PR9  7","PR9  7","Total",11302,5396,5906,11198,104,137,412.70,27.4
"2011","PR9  8","PR9  8","Total",10127,4834,5293,10098,29,93,3228.61,3.1
"2011","PR9  9","PR9  9","Total",14260,6652,7608,13784,476,181,751.19,19.0
"2011","RG1  1","RG1  1","Total",437,255,182,437,0,1,4.66,93.8
"2011","RG1  2","RG1  2","Total",4036,2126,1910,3900,136,28,33.27,121.3
"2011","RG1  3","RG1  3","Total",7390,3975,3415,7239,151,75,138.63,53.3
"2011","RG1  4","RG1  4","Total",2590,1419,1171,2567,23,8,28.15,92.0
"2011","RG1  5","RG1  5","Total",9454,4836,4618,8508,946,152,138.58,68.2
"2011","RG1  6","RG1  6","Total",8793,4358,4435,8626,167,90,296.77,29.6
"2011","RG1  7","RG1  7","Total",7078,3826,3252,7070,8,47,114.62,61.8
"2011","RG1  8","RG1  8","Total",2554,1376,1178,2554,0,19,124.07,20.6
"2011","RG10 0","RG10 0","Total",5721,2810,2911,5721,0,118,2795.26,2.0
"2011","RG10 8","RG10 8","Total",3648,1795,1853,3577,71,141,1589.08,2.3
"2011","RG10 9","RG10 9","Total",8887,4379,4508,8789,98,182,1689.95,5.3
"2011","RG12 0","RG12 0","Total",7477,3668,3809,7477,0,69,130.68,57.2
"2011","RG12 2","RG12 2","Total",5595,2776,2819,5532,63,79,167.75,33.4
"2011","RG12 7","RG12 7","Total",17418,8571,8847,17338,80,182,411.73,42.3
"2011","RG12 8","RG12 8","Total",11317,5540,5777,11317,0,153,469.72,24.1
"2011","RG12 9","RG12 9","Total",10076,5030,5046,10076,0,124,309.93,32.5
"2011","RG14 1","RG14 1","Total",6468,3147,3321,6408,60,103,310.46,20.8
"2011","RG14 2","RG14 2","Total",8257,4118,4139,8184,73,82,864.59,9.6
"2011","RG14 3","RG14 3","Total",883,452,431,622,261,27,1240.70,0.7
"2011","RG14 5","RG14 5","Total",4426,2275,2151,4410,16,41,176.85,25.0
"2011","RG14 6","RG14 6","Total",8651,4220,4431,8592,59,201,343.97,25.2
"2011","RG14 7","RG14 7","Total",9153,4561,4592,9094,59,147,285.32,32.1
"2011","RG17 0","RG17 0","Total",6130,2971,3159,6032,98,91,3643.21,1.7
"2011","RG17 7","RG17 7","Total",2475,1236,1239,2456,19,56,6601.23,0.4
"2011","RG17 8","RG17 8","Total",3100,1538,1562,3072,28,65,2581.69,1.2
"2011","RG17 9","RG17 9","Total",3389,1697,1692,3342,47,107,4781.64,0.7
"2011","RG18 0","RG18 0","Total",1201,615,586,1200,1,23,2334.79,0.5
"2011","RG18 3","RG18 3","Total",6783,3368,3415,6743,40,82,275.32,24.6
"2011","RG18 4","RG18 4","Total",4792,2379,2413,4726,66,86,453.36,10.6
"2011","RG18 9","RG18 9","Total",6280,2948,3332,5602,678,161,2166.14,2.9
"2011","RG19 3","RG19 3","Total",7220,3626,3594,7215,5,80,295.21,24.5
"2011","RG19 4","RG19 4","Total",7222,3668,3554,7113,109,123,1284.47,5.6
"2011","RG19 8","RG19 8","Total",3214,1572,1642,3162,52,69,2638.17,1.2
"2011","RG2  0","RG2  0","Total",5661,2911,2750,5659,2,34,358.78,15.8
"2011","RG2  7","RG2  7","Total",11447,5715,5732,10454,993,125,247.83,46.2
"2011","RG2  8","RG2  8","Total",12338,5997,6341,12309,29,88,377.19,32.7
"2011","RG2  9","RG2  9","Total",8170,4145,4025,7843,327,113,1417.03,5.8
"2011","RG20 0","RG20 0","Total",2221,1103,1118,2220,1,96,4831.13,0.5
"2011","RG20 4","RG20 4","Total",1048,520,528,1048,0,38,1797.46,0.6
"2011","RG20 5","RG20 5","Total",3164,1550,1614,3164,0,57,1515.73,2.1
"2011","RG20 6","RG20 6","Total",1571,816,755,1557,14,34,1502.19,1.0
"2011","RG20 7","RG20 7","Total",2046,996,1050,2035,11,70,5525.70,0.4
"2011","RG20 8","RG20 8","Total",3653,1812,1841,3596,57,123,7472.16,0.5
"2011","RG20 9","RG20 9","Total",5181,2579,2602,4974,207,211,5283.61,1.0
"2011","RG21 3","RG21 3","Total",7907,3956,3951,7847,60,125,317.07,24.9
"2011","RG21 4","RG21 4","Total",3136,1617,1519,3133,3,36,240.77,13.0
"2011","RG21 5","RG21 5","Total",7787,3765,4022,7642,145,56,259.15,30.0
"2011","RG21 6","RG21 6","Total",506,266,240,506,0,7,15.77,32.1
"2011","RG21 7","RG21 7","Total",3632,1943,1689,3616,16,19,38.83,93.5
"2011","RG21 8","RG21 8","Total",3959,1972,1987,3914,45,42,106.51,37.2
"2011","RG22 4","RG22 4","Total",20955,10337,10618,20955,0,304,483.84,43.3
"2011","RG22 5","RG22 5","Total",10435,5123,5312,10424,11,140,341.29,30.6
"2011","RG22 6","RG22 6","Total",10372,5030,5342,10319,53,82,279.27,37.1
"2011","RG23 7","RG23 7","Total",5288,2588,2700,5244,44,123,2296.24,2.3
"2011","RG23 8","RG23 8","Total",6981,3462,3519,6931,50,86,1065.93,6.5
"2011","RG24 7","RG24 7","Total",4041,1960,2081,3987,54,75,1472.53,2.7
"2011","RG24 8","RG24 8","Total",11200,5563,5637,11198,2,226,438.63,25.5
"2011","RG24 9","RG24 9","Total",16015,7888,8127,15803,212,126,1845.52,8.7
"2011","RG25 2","RG25 2","Total",4183,2110,2073,4171,12,138,11005.74,0.4
"2011","RG25 3","RG25 3","Total",4522,2250,2272,4472,50,89,4467.89,1.0
"2011","RG26 3","RG26 3","Total",8445,4262,4183,8372,73,134,1099.28,7.7
"2011","RG26 4","RG26 4","Total",4553,2293,2260,4523,30,57,190.23,23.9
"2011","RG26 5","RG26 5","Total",9135,4530,4605,9084,51,206,7400.48,1.2
"2011","RG27 0","RG27 0","Total",5473,2729,2744,5420,53,139,5311.30,1.0
"2011","RG27 8","RG27 8","Total",6525,3207,3318,6460,65,186,4683.56,1.4
"2011","RG27 9","RG27 9","Total",9028,4447,4581,8849,179,264,2695.83,3.3
"2011","RG28 7","RG28 7","Total",5786,2800,2986,5729,57,162,7445.29,0.8
"2011","RG29 1","RG29 1","Total",7143,3805,3338,6164,979,189,4717.91,1.5
"2011","RG30 1","RG30 1","Total",4940,2511,2429,4940,0,33,205.40,24.1
"2011","RG30 2","RG30 2","Total",12408,6361,6047,12173,235,102,162.75,76.2
"2011","RG30 3","RG30 3","Total",8542,4080,4462,8482,60,117,1663.85,5.1
"2011","RG30 4","RG30 4","Total",12010,5776,6234,11956,54,126,336.35,35.7
"2011","RG30 6","RG30 6","Total",6231,3011,3220,6108,123,72,124.70,50.0
"2011","RG31 4","RG31 4","Total",4468,2181,2287,4468,0,59,164.73,27.1
"2011","RG31 5","RG31 5","Total",6676,3236,3440,6664,12,128,205.45,32.5
"2011","RG31 6","RG31 6","Total",9562,4748,4814,9538,24,214,352.08,27.2
"2011","RG31 7","RG31 7","Total",6570,3245,3325,6559,11,120,276.54,23.8
"2011","RG4  5","RG4  5","Total",6777,3263,3514,6743,34,88,124.50,54.4
"2011","RG4  6","RG4  6","Total",7182,3543,3639,7078,104,114,605.85,11.9
"2011","RG4  7","RG4  7","Total",9079,4466,4613,9023,56,262,304.07,29.9
"2011","RG4  8","RG4  8","Total",10327,4996,5331,10133,194,182,391.15,26.4
"2011","RG4  9","RG4  9","Total",5769,2813,2956,5693,76,147,3627.08,1.6
"2011","RG40 1","RG40 1","Total",7704,3649,4055,7596,108,113,307.18,25.1
"2011","RG40 2","RG40 2","Total",4558,2228,2330,4450,108,103,231.19,19.7
"2011","RG40 3","RG40 3","Total",4640,2406,2234,4437,203,183,1467.93,3.2
"2011","RG40 4","RG40 4","Total",7794,3842,3952,7739,55,207,1156.54,6.7
"2011","RG40 5","RG40 5","Total",1784,896,888,1784,0,41,786.21,2.3
"2011","RG41 1","RG41 1","Total",3739,1916,1823,3739,0,86,234.63,15.9
"2011","RG41 2","RG41 2","Total",4756,2287,2469,4589,167,94,224.38,21.2
"2011","RG41 3","RG41 3","Total",6530,3197,3333,6530,0,185,174.13,37.5
"2011","RG41 4","RG41 4","Total",3917,1892,2025,3917,0,126,666.21,5.9
"2011","RG41 5","RG41 5","Total",9284,4552,4732,9103,181,185,953.30,9.7
"2011","RG42 1","RG42 1","Total",4670,2295,2375,4670,0,52,188.20,24.8
"2011","RG42 2","RG42 2","Total",6382,3148,3234,6382,0,82,146.24,43.6
"2011","RG42 3","RG42 3","Total",5889,2837,3052,5885,4,105,165.49,35.6
"2011","RG42 4","RG42 4","Total",4279,2099,2180,4154,125,92,425.38,10.1
"2011","RG42 5","RG42 5","Total",1652,818,834,1652,0,54,772.56,2.1
"2011","RG42 6","RG42 6","Total",1429,720,709,1421,8,64,1184.34,1.2
"2011","RG42 7","RG42 7","Total",1740,859,881,1740,0,24,101.00,17.2
"2011","RG45 6","RG45 6","Total",8596,4240,4356,8390,206,240,559.97,15.4
"2011","RG45 7","RG45 7","Total",5969,3127,2842,5059,910,176,1427.48,4.2
"2011","RG5  3","RG5  3","Total",10948,5446,5502,10939,9,134,290.07,37.7
"2011","RG5  4","RG5  4","Total",14287,7054,7233,14255,32,257,510.00,28.0
"2011","RG6  1","RG6  1","Total",8622,4361,4261,8154,468,174,275.99,31.2
"2011","RG6  3","RG6  3","Total",6072,3034,3038,5985,87,110,179.54,33.8
"2011","RG6  4","RG6  4","Total",7690,3881,3809,7689,1,160,197.44,38.9
"2011","RG6  5","RG6  5","Total",6514,3193,3321,6271,243,184,155.15,42.0
"2011","RG6  6","RG6  6","Total",1180,560,620,74,1106,37,34.99,33.7
"2011","RG6  7","RG6  7","Total",7859,3954,3905,7686,173,185,284.61,27.6
"2011","RG7  1","RG7  1","Total",6715,3361,3354,6642,73,113,2608.69,2.6
"2011","RG7  2","RG7  2","Total",2029,1007,1022,2026,3,61,3924.05,0.5
"2011","RG7  3","RG7  3","Total",10046,4945,5101,9984,62,185,1681.88,6.0
"2011","RG7  4","RG7  4","Total",3064,1569,1495,2952,112,61,4255.72,0.7
"2011","RG7  5","RG7  5","Total",5618,2822,2796,5519,99,98,3026.53,1.9
"2011","RG7  6","RG7  6","Total",4472,2328,2144,3838,634,174,4332.42,1.0
"2011","RG8  0","RG8  0","Total",5398,2750,2648,5176,222,190,3173.84,1.7
"2011","RG8  7","RG8  7","Total",4552,2161,2391,4503,49,134,1956.21,2.3
"2011","RG8  8","RG8  8","Total",5891,2981,2910,5636,255,178,3060.53,1.9
"2011","RG8  9","RG8  9","Total",3091,1486,1605,2987,104,113,3327.01,0.9
"2011","RG9  1","RG9  1","Total",9150,4308,4842,9051,99,187,387.39,23.6
"2011","RG9  2","RG9  2","Total",2469,1106,1363,2468,1,50,170.33,14.5
"2011","RG9  3","RG9  3","Total",1969,943,1026,1903,66,73,1124.96,1.8
"2011","RG9  4","RG9  4","Total",2128,1151,977,1865,263,102,2539.79,0.8
"2011","RG9  5","RG9  5","Total",4242,2187,2055,3849,393,148,3804.82,1.1
"2011","RG9  6","RG9  6","Total",3196,1571,1625,3177,19,125,8035.92,0.4
"2011","RH1  1","RH1  1","Total",5189,2574,2615,5144,45,50,105.12,49.4
"2011","RH1  2","RH1  2","Total",7465,3667,3798,7337,128,90,162.43,46.0
"2011","RH1  3","RH1  3","Total",8473,4129,4344,8299,174,90,950.28,8.9
"2011","RH1  4","RH1  4","Total",5891,2913,2978,5847,44,105,1746.37,3.4
"2011","RH1  5","RH1  5","Total",8316,4068,4248,8125,191,123,2446.18,3.4
"2011","RH1  6","RH1  6","Total",10791,5369,5422,10667,124,173,319.90,33.7
"2011","RH10 1","RH10 1","Total",6705,3382,3323,6632,73,41,187.50,35.8
"2011","RH10 3","RH10 3","Total",12129,6123,6006,11940,189,203,1213.13,10.0
"2011","RH10 4","RH10 4","Total",7087,3593,3494,6766,321,154,2838.15,2.5
"2011","RH10 5","RH10 5","Total",6078,2937,3141,6078,0,53,283.06,21.5
"2011","RH10 6","RH10 6","Total",9542,4678,4864,9460,82,100,314.50,30.3
"2011","RH10 7","RH10 7","Total",17613,8727,8886,17599,14,223,391.69,45.0
"2011","RH10 8","RH10 8","Total",6065,3114,2951,6065,0,45,498.95,12.2
"2011","RH11 0","RH11 0","Total",9527,4617,4910,9296,231,96,1085.37,8.8
"2011","RH11 6","RH11 6","Total",2838,1408,1430,2838,0,34,66.78,42.5
"2011","RH11 7","RH11 7","Total",13156,6623,6533,12984,172,89,1278.33,10.3
"2011","RH11 8","RH11 8","Total",15769,7728,8041,15605,164,170,306.88,51.4
"2011","RH11 9","RH11 9","Total",14526,7057,7469,14455,71,136,2060.81,7.0
"2011","RH12 1","RH12 1","Total",7208,3505,3703,7109,99,109,303.72,23.7
"2011","RH12 2","RH12 2","Total",7673,3738,3935,7564,109,133,300.82,25.5
"2011","RH12 3","RH12 3","Total",8688,4201,4487,8327,361,233,6045.10,1.4
"2011","RH12 4","RH12 4","Total",10069,4902,5167,10003,66,127,3882.46,2.6
"2011","RH12 5","RH12 5","Total",10138,4860,5278,10079,59,185,238.12,42.6
"2011","RH13 0","RH13 0","Total",5064,2526,2538,4165,899,172,3243.55,1.6
"2011","RH13 5","RH13 5","Total",9331,4546,4785,9207,124,131,195.08,47.8
"2011","RH13 6","RH13 6","Total",8314,4027,4287,8219,95,202,3979.05,2.1
"2011","RH13 8","RH13 8","Total",6370,3155,3215,6262,108,160,7690.62,0.8
"2011","RH13 9","RH13 9","Total",9029,4527,4502,9029,0,167,1018.46,8.9
"2011","RH14 0","RH14 0","Total",5855,2867,2988,5855,0,201,7691.26,0.8
"2011","RH14 9","RH14 9","Total",8232,4053,4179,8172,60,139,3219.23,2.6
"2011","RH15 0","RH15 0","Total",10988,5286,5702,10621,367,148,992.09,11.1
"2011","RH15 8","RH15 8","Total",11652,5625,6027,11517,135,154,1284.09,9.1
"2011","RH15 9","RH15 9","Total",8905,4406,4499,8847,58,101,299.96,29.7
"2011","RH16 1","RH16 1","Total",7049,3490,3559,6969,80,160,344.59,20.5
"2011","RH16 2","RH16 2","Total",7255,3471,3784,7148,107,167,1286.50,5.6
"2011","RH16 3","RH16 3","Total",10173,4903,5270,10133,40,113,273.76,37.2
"2011","RH16 4","RH16 4","Total",9073,4459,4614,8879,194,93,275.88,32.9
"2011","RH17 5","RH17 5","Total",6813,3293,3520,6642,171,203,5781.69,1.2
"2011","RH17 6","RH17 6","Total",5477,2768,2709,5116,361,113,4989.81,1.1
"2011","RH17 7","RH17 7","Total",6973,3416,3557,6792,181,212,5856.09,1.2
"2011","RH18 5","RH18 5","Total",4453,2125,2328,4431,22,136,1994.11,2.2
"2011","RH19 1","RH19 1","Total",7145,3497,3648,7048,97,133,298.76,23.9
"2011","RH19 2","RH19 2","Total",7202,3522,3680,7146,56,148,1108.76,6.5
"2011","RH19 3","RH19 3","Total",11043,5464,5579,10749,294,196,2115.01,5.2
"2011","RH19 4","RH19 4","Total",8089,3979,4110,7874,215,190,3464.40,2.3
"2011","RH2  0","RH2  0","Total",7851,3770,4081,7268,583,208,558.20,14.1
"2011","RH2  7","RH2  7","Total",7355,3563,3792,7302,53,129,544.95,13.5
"2011","RH2  8","RH2  8","Total",7070,3442,3628,7013,57,119,2527.41,2.8
"2011","RH2  9","RH2  9","Total",3953,1910,2043,3838,115,63,360.23,11.0
"2011","RH20 1","RH20 1","Total",5013,2431,2582,4899,114,163,6909.57,0.7
"2011","RH20 2","RH20 2","Total",6780,3265,3515,6737,43,171,3982.44,1.7
"2011","RH20 3","RH20 3","Total",6428,3180,3248,6426,2,128,2623.07,2.5
"2011","RH20 4","RH20 4","Total",6747,3204,3543,6504,243,99,2740.86,2.5
"2011","RH3  7","RH3  7","Total",4366,2109,2257,4281,85,116,1869.37,2.3
"2011","RH4  1","RH4  1","Total",5223,2495,2728,5120,103,98,668.07,7.8
"2011","RH4  2","RH4  2","Total",4998,2428,2570,4959,39,83,125.85,39.7
"2011","RH4  3","RH4  3","Total",5258,2531,2727,5086,172,128,1180.87,4.5
"2011","RH5  4","RH5  4","Total",7105,3531,3574,7036,69,157,2210.88,3.2
"2011","RH5  5","RH5  5","Total",5314,2641,2673,5306,8,138,6055.49,0.9
"2011","RH5  6","RH5  6","Total",4126,2011,2115,3648,478,162,6809.88,0.6
"2011","RH6  0","RH6  0","Total",2633,1325,1308,2524,109,51,2133.65,1.2
"2011","RH6  7","RH6  7","Total",5988,2982,3006,5778,210,47,158.33,37.8
"2011","RH6  8","RH6  8","Total",8989,4412,4577,8977,12,102,378.74,23.7
"2011","RH6  9","RH6  9","Total",11707,5797,5910,11668,39,143,1916.60,6.1
"2011","RH7  6","RH7  6","Total",9222,4473,4749,8746,476,159,6045.43,1.5
"2011","RH8  0","RH8  0","Total",9717,4638,5079,9513,204,270,2453.97,4.0
"2011","RH8  9","RH8  9","Total",5829,2858,2971,5719,110,134,2012.54,2.9
"2011","RH9  8","RH9  8","Total",5443,2569,2874,5309,134,71,2951.01,1.8
"2011","RM1  1","RM1  1","Total",1538,745,793,1538,0,4,28.61,53.8
"2011","RM1  2","RM1  2","Total",4296,2088,2208,4194,102,29,67.17,64.0
"2011","RM1  3","RM1  3","Total",1815,902,913,1765,50,12,48.24,37.6
"2011","RM1  4","RM1  4","Total",11961,5791,6170,11948,13,160,239.34,50.0
"2011","RM10 7","RM10 7","Total",10993,5192,5801,10864,129,75,175.47,62.6
"2011","RM10 8","RM10 8","Total",14801,7196,7605,14767,34,141,239.40,61.8
"2011","RM10 9","RM10 9","Total",12387,5923,6464,12261,126,120,381.44,32.5
"2011","RM11 1","RM11 1","Total",11559,5532,6027,11507,52,168,247.77,46.7
"2011","RM11 2","RM11 2","Total",9622,4616,5006,9580,42,115,223.72,43.0
"2011","RM11 3","RM11 3","Total",10596,5117,5479,10511,85,166,409.10,25.9
"2011","RM12 4","RM12 4","Total",16114,7844,8270,16013,101,159,382.93,42.1
"2011","RM12 5","RM12 5","Total",9824,4703,5121,9824,0,97,199.74,49.2
"2011","RM12 6","RM12 6","Total",8302,3952,4350,8302,0,85,227.03,36.6
"2011","RM13 7","RM13 7","Total",9035,4275,4760,8990,45,80,224.43,40.3
"2011","RM13 8","RM13 8","Total",7399,3747,3652,7392,7,61,456.99,16.2
"2011","RM13 9","RM13 9","Total",12482,6019,6463,12457,25,111,1534.21,8.1
"2011","RM14 1","RM14 1","Total",11267,5352,5915,11245,22,152,912.73,12.3
"2011","RM14 2","RM14 2","Total",8350,4011,4339,8248,102,103,406.85,20.5
"2011","RM14 3","RM14 3","Total",7413,3615,3798,7292,121,135,4393.97,1.7
"2011","RM15 4","RM15 4","Total",7986,3945,4041,7973,13,49,919.51,8.7
"2011","RM15 5","RM15 5","Total",11192,5564,5628,11150,42,63,379.38,29.5
"2011","RM15 6","RM15 6","Total",8268,4070,4198,8252,16,58,1400.79,5.9
"2011","RM16 2","RM16 2","Total",12230,6015,6215,12215,15,142,505.68,24.2
"2011","RM16 3","RM16 3","Total",3587,1748,1839,3535,52,51,1269.21,2.8
"2011","RM16 4","RM16 4","Total",9864,4718,5146,9744,120,48,358.75,27.5
"2011","RM16 5","RM16 5","Total",758,378,380,744,14,9,119.39,6.3
"2011","RM16 6","RM16 6","Total",14697,7317,7380,14691,6,144,254.17,57.8
"2011","RM17 5","RM17 5","Total",12354,6222,6132,12294,60,125,356.40,34.7
"2011","RM17 6","RM17 6","Total",15051,7559,7492,14924,127,96,266.43,56.5
"2011","RM18 7","RM18 7","Total",4728,2248,2480,4664,64,30,442.90,10.7
"2011","RM18 8","RM18 8","Total",11936,5847,6089,11934,2,79,2047.33,5.8
"2011","RM19 1","RM19 1","Total",6527,3265,3262,6526,1,41,479.87,13.6
"2011","RM2  5","RM2  5","Total",6602,3206,3396,6567,35,85,246.90,26.7
"2011","RM2  6","RM2  6","Total",6582,3238,3344,6558,24,91,148.83,44.2
"2011","RM20 3","RM20 3","Total",1958,1009,949,1958,0,8,596.57,3.3
"2011","RM20 4","RM20 4","Total",2919,1508,1411,2919,0,18,65.12,44.8
"2011","RM3  0","RM3  0","Total",10267,4956,5311,10201,66,93,448.78,22.9
"2011","RM3  7","RM3  7","Total",9122,4335,4787,9111,11,52,266.49,34.2
"2011","RM3  8","RM3  8","Total",10551,5004,5547,10412,139,83,160.96,65.6
"2011","RM3  9","RM3  9","Total",10447,5036,5411,10333,114,61,445.71,23.4
"2011","RM4  1","RM4  1","Total",4191,2048,2143,4169,22,41,3435.17,1.2
"2011","RM5  2","RM5  2","Total",8810,4205,4605,8733,77,38,416.68,21.1
"2011","RM5  3","RM5  3","Total",9534,4515,5019,9428,106,71,211.07,45.2
"2011","RM6  4","RM6  4","Total",11632,5703,5929,11586,46,125,120.69,96.4
"2011","RM6  5","RM6  5","Total",11770,5528,6242,11654,116,123,868.54,13.6
"2011","RM6  6","RM6  6","Total",9300,4519,4781,9288,12,99,195.63,47.5
"2011","RM7  0","RM7  0","Total",10834,5234,5600,10550,284,101,416.80,26.0
"2011","RM7  7","RM7  7","Total",5003,2395,2608,4936,67,23,81.26,61.6
"2011","RM7  8","RM7  8","Total",7555,3586,3969,7549,6,53,198.41,38.1
"2011","RM7  9","RM7  9","Total",5539,2684,2855,5451,88,53,171.95,32.2
"2011","RM8  1","RM8  1","Total",11371,5450,5921,11314,57,110,221.90,51.2
"2011","RM8  2","RM8  2","Total",15833,7569,8264,15814,19,147,185.98,85.1
"2011","RM8  3","RM8  3","Total",11869,5576,6293,11803,66,108,134.72,88.1
"2011","RM9  4","RM9  4","Total",12880,6314,6566,12870,10,107,200.28,64.3
"2011","RM9  5","RM9  5","Total",12027,5701,6326,11993,34,95,201.32,59.7
"2011","RM9  6","RM9  6","Total",11296,5349,5947,11211,85,97,132.51,85.2
"2011","S1   2","S1   2","Total",1330,594,736,1129,201,10,39.01,34.1
"2011","S1   3","S1   3","Total",243,98,145,177,66,3,7.25,33.5
"2011","S1   4","S1   4","Total",9078,4550,4528,6681,2397,117,96.37,94.2
"2011","S10  1","S10  1","Total",15322,7672,7650,15278,44,146,175.04,87.5
"2011","S10  2","S10  2","Total",5730,3020,2710,5389,341,51,99.12,57.8
"2011","S10  3","S10  3","Total",10848,5251,5597,8558,2290,232,281.17,38.6
"2011","S10  4","S10  4","Total",6917,3344,3573,6916,1,171,3128.63,2.2
"2011","S10  5","S10  5","Total",8591,4098,4493,8457,134,162,325.47,26.4
"2011","S11  7","S11  7","Total",10637,5120,5517,10637,0,280,498.02,21.4
"2011","S11  8","S11  8","Total",13809,7079,6730,13716,93,145,154.54,89.4
"2011","S11  9","S11  9","Total",9937,4841,5096,9803,134,315,440.19,22.6
"2011","S12  2","S12  2","Total",11907,5809,6098,11778,129,70,255.98,46.5
"2011","S12  3","S12  3","Total",8711,4186,4525,8624,87,53,1482.87,5.9
"2011","S12  4","S12  4","Total",13724,6668,7056,13598,126,69,408.37,33.6
"2011","S13  7","S13  7","Total",9655,4714,4941,9455,200,36,393.96,24.5
"2011","S13  8","S13  8","Total",13314,6386,6928,13242,72,52,349.42,38.1
"2011","S13  9","S13  9","Total",7701,3782,3919,7701,0,42,511.80,15.0
"2011","S14  1","S14  1","Total",9665,4633,5032,9605,60,42,229.29,42.2
"2011","S17  3","S17  3","Total",7427,3519,3908,7374,53,160,1125.14,6.6
"2011","S17  4","S17  4","Total",8159,3941,4218,8100,59,142,378.74,21.5
"2011","S18  1","S18  1","Total",6980,3417,3563,6978,2,94,358.58,19.5
"2011","S18  2","S18  2","Total",5935,2837,3098,5837,98,63,408.03,14.5
"2011","S18  3","S18  3","Total",1628,794,834,1628,0,18,171.65,9.5
"2011","S18  4","S18  4","Total",1577,795,782,1577,0,13,404.61,3.9
"2011","S18  7","S18  7","Total",1891,928,963,1891,0,26,3982.14,0.5
"2011","S18  8","S18  8","Total",6718,3285,3433,6678,40,94,458.20,14.7
"2011","S2   1","S2   1","Total",9678,4774,4904,9674,4,36,314.53,30.8
"2011","S2   2","S2   2","Total",11248,5560,5688,10891,357,66,266.80,42.2
"2011","S2   3","S2   3","Total",8212,4065,4147,8088,124,34,176.77,46.5
"2011","S2   4","S2   4","Total",6535,3346,3189,4889,1646,62,70.72,92.4
"2011","S2   5","S2   5","Total",8856,4714,4142,8842,14,49,272.51,32.5
"2011","S20  1","S20  1","Total",6849,3319,3530,6769,80,42,245.46,27.9
"2011","S20  2","S20  2","Total",3934,1973,1961,3934,0,43,164.57,23.9
"2011","S20  3","S20  3","Total",332,171,161,332,0,5,71.47,4.6
"2011","S20  4","S20  4","Total",3992,1993,1999,3961,31,25,102.86,38.8
"2011","S20  5","S20  5","Total",5605,2764,2841,5605,0,32,489.57,11.4
"2011","S20  6","S20  6","Total",2593,1252,1341,2593,0,35,89.99,28.8
"2011","S20  7","S20  7","Total",3967,1905,2062,3967,0,19,126.95,31.2
"2011","S20  8","S20  8","Total",4110,2025,2085,4084,26,23,78.77,52.2
"2011","S21  1","S21  1","Total",7987,3943,4044,7932,55,71,392.45,20.4
"2011","S21  2","S21  2","Total",1458,709,749,1458,0,4,236.04,6.2
"2011","S21  3","S21  3","Total",3005,1524,1481,2941,64,18,1489.90,2.0
"2011","S21  4","S21  4","Total",7386,3586,3800,7269,117,45,839.39,8.8
"2011","S21  5","S21  5","Total",1194,588,606,1194,0,15,968.18,1.2
"2011","S25  1","S25  1","Total",1241,606,635,1241,0,13,952.33,1.3
"2011","S25  2","S25  2","Total",8733,4293,4440,8619,114,91,1005.87,8.7
"2011","S25  3","S25  3","Total",2018,1000,1018,2010,8,19,369.32,5.5
"2011","S25  4","S25  4","Total",6604,3259,3345,6589,15,59,569.88,11.6
"2011","S25  5","S25  5","Total",2505,1220,1285,2505,0,47,311.63,8.0
"2011","S26  1","S26  1","Total",1634,784,850,1633,1,25,730.44,2.2
"2011","S26  2","S26  2","Total",6904,3389,3515,6897,7,66,672.46,10.3
"2011","S26  3","S26  3","Total",2539,1243,1296,2522,17,12,573.97,4.4
"2011","S26  4","S26  4","Total",5863,2866,2997,5809,54,45,395.61,14.8
"2011","S26  5","S26  5","Total",3266,1591,1675,3266,0,25,757.06,4.3
"2011","S26  6","S26  6","Total",3803,1870,1933,3803,0,40,272.30,14.0
"2011","S26  7","S26  7","Total",1879,897,982,1879,0,22,1232.02,1.5
"2011","S3   7","S3   7","Total",10905,5808,5097,8802,2103,82,98.81,110.4
"2011","S3   8","S3   8","Total",3074,1795,1279,2443,631,23,127.39,24.1
"2011","S3   9","S3   9","Total",5351,2872,2479,5264,87,28,104.62,51.1
"2011","S32  1","S32  1","Total",2018,954,1064,1969,49,53,2969.80,0.7
"2011","S32  2","S32  2","Total",909,475,434,897,12,31,1084.99,0.8
"2011","S32  3","S32  3","Total",1331,637,694,1300,31,35,999.44,1.3
"2011","S32  4","S32  4","Total",470,227,243,470,0,7,529.97,0.9
"2011","S32  5","S32  5","Total",969,462,507,969,0,22,1066.73,0.9
"2011","S33  0","S33  0","Total",1531,751,780,1527,4,32,1363.50,1.1
"2011","S33  6","S33  6","Total",1019,499,520,1019,0,20,11372.90,0.1
"2011","S33  7","S33  7","Total",353,173,180,342,11,10,2848.31,0.1
"2011","S33  8","S33  8","Total",642,303,339,635,7,13,1176.63,0.5
"2011","S33  9","S33  9","Total",1416,705,711,1412,4,20,879.76,1.6
"2011","S35  0","S35  0","Total",6524,3215,3309,6504,20,86,712.37,9.2
"2011","S35  1","S35  1","Total",7237,3548,3689,7180,57,65,436.36,16.6
"2011","S35  2","S35  2","Total",6157,3043,3114,6090,67,47,267.62,23.0
"2011","S35  3","S35  3","Total",3302,1613,1689,3283,19,16,89.47,36.9
"2011","S35  4","S35  4","Total",6360,3038,3322,6341,19,43,265.07,24.0
"2011","S35  7","S35  7","Total",2941,1445,1496,2941,0,47,3687.87,0.8
"2011","S35  8","S35  8","Total",4532,2156,2376,4530,2,54,634.97,7.1
"2011","S35  9","S35  9","Total",4348,2108,2240,4288,60,25,436.79,10.0
"2011","S36  1","S36  1","Total",6969,3406,3563,6835,134,54,553.34,12.6
"2011","S36  2","S36  2","Total",6100,2998,3102,6086,14,64,222.96,27.4
"2011","S36  3","S36  3","Total",386,190,196,386,0,0,1126.99,0.3
"2011","S36  4","S36  4","Total",715,369,346,709,6,6,7728.38,0.1
"2011","S36  6","S36  6","Total",6726,3314,3412,6721,5,76,306.04,22.0
"2011","S36  7","S36  7","Total",1658,833,825,1658,0,28,1880.14,0.9
"2011","S36  8","S36  8","Total",1766,897,869,1766,0,40,535.25,3.3
"2011","S36  9","S36  9","Total",3027,1510,1517,3022,5,45,2748.19,1.1
"2011","S4   7","S4   7","Total",7047,3484,3563,6964,83,45,147.94,47.6
"2011","S4   8","S4   8","Total",7418,3752,3666,7282,136,31,196.69,37.7
"2011","S40  1","S40  1","Total",4071,2041,2030,4067,4,42,110.82,36.7
"2011","S40  2","S40  2","Total",10990,5418,5572,10990,0,76,312.27,35.2
"2011","S40  3","S40  3","Total",9419,4498,4921,9289,130,201,346.85,27.2
"2011","S40  4","S40  4","Total",10918,5372,5546,10807,111,137,357.60,30.5
"2011","S41  0","S41  0","Total",12936,6328,6608,12697,239,158,992.61,13.0
"2011","S41  7","S41  7","Total",6211,3152,3059,6127,84,47,209.94,29.6
"2011","S41  8","S41  8","Total",11504,5587,5917,11400,104,130,599.35,19.2
"2011","S41  9","S41  9","Total",5751,2842,2909,5669,82,37,705.96,8.1
"2011","S42  5","S42  5","Total",12090,5958,6132,12000,90,79,1090.09,11.1
"2011","S42  6","S42  6","Total",11307,5565,5742,11257,50,160,2329.42,4.9
"2011","S42  7","S42  7","Total",4831,2400,2431,4788,43,117,3617.90,1.3
"2011","S43  1","S43  1","Total",8788,4235,4553,8576,212,70,533.30,16.5
"2011","S43  2","S43  2","Total",7296,3619,3677,7241,55,43,992.83,7.3
"2011","S43  3","S43  3","Total",13700,6706,6994,13631,69,93,1391.59,9.8
"2011","S43  4","S43  4","Total",10565,5218,5347,10490,75,97,1048.37,10.1
"2011","S44  5","S44  5","Total",8293,4026,4267,8234,59,65,3283.52,2.5
"2011","S44  6","S44  6","Total",13407,6560,6847,13304,103,93,3902.55,3.4
"2011","S45  0","S45  0","Total",1576,757,819,1558,18,34,3258.39,0.5
"2011","S45  8","S45  8","Total",3841,1903,1938,3841,0,31,2256.02,1.7
"2011","S45  9","S45  9","Total",8205,4057,4148,8100,105,60,845.68,9.7
"2011","S5   0","S5   0","Total",11281,5320,5961,11276,5,56,278.68,40.5
"2011","S5   6","S5   6","Total",12926,6198,6728,12759,167,65,227.76,56.8
"2011","S5   7","S5   7","Total",12833,6272,6561,12688,145,47,300.22,42.7
"2011","S5   8","S5   8","Total",13176,6426,6750,13118,58,56,339.47,38.8
"2011","S5   9","S5   9","Total",9652,4731,4921,9616,36,46,235.71,40.9
"2011","S6   1","S6   1","Total",11745,5771,5974,11642,103,72,399.66,29.4
"2011","S6   2","S6   2","Total",7769,3813,3956,7769,0,23,236.20,32.9
"2011","S6   3","S6   3","Total",7787,4139,3648,7692,95,51,136.38,57.1
"2011","S6   4","S6   4","Total",13282,6396,6886,13248,34,106,207.09,64.1
"2011","S6   5","S6   5","Total",9748,4794,4954,9717,31,86,428.43,22.8
"2011","S6   6","S6   6","Total",7921,3838,4083,7877,44,99,9374.68,0.8
"2011","S60  1","S60  1","Total",1255,661,594,1246,9,4,62.89,20.0
"2011","S60  2","S60  2","Total",6799,3369,3430,6654,145,67,302.11,22.5
"2011","S60  3","S60  3","Total",7661,3730,3931,7574,87,140,305.34,25.1
"2011","S60  4","S60  4","Total",6391,3147,3244,6376,15,69,1059.62,6.0
"2011","S60  5","S60  5","Total",15189,7418,7771,15123,66,100,1242.01,12.2
"2011","S61  1","S61  1","Total",7153,3583,3570,7079,74,45,216.98,33.0
"2011","S61  2","S61  2","Total",12772,6313,6459,12758,14,131,1101.13,11.6
"2011","S61  3","S61  3","Total",7766,3745,4021,7693,73,30,189.29,41.0
"2011","S61  4","S61  4","Total",8129,4115,4014,8048,81,41,571.17,14.2
"2011","S62  5","S62  5","Total",6717,3220,3497,6717,0,41,330.57,20.3
"2011","S62  6","S62  6","Total",4565,2234,2331,4433,132,20,319.91,14.3
"2011","S62  7","S62  7","Total",8694,4240,4454,8627,67,70,2602.14,3.3
"2011","S63  0","S63  0","Total",8687,4245,4442,8611,76,33,503.47,17.3
"2011","S63  6","S63  6","Total",8978,4382,4596,8888,90,61,446.00,20.1
"2011","S63  7","S63  7","Total",6731,3265,3466,6605,126,68,767.37,8.8
"2011","S63  8","S63  8","Total",7136,3465,3671,7087,49,28,465.27,15.3
"2011","S63  9","S63  9","Total",6564,3249,3315,6551,13,40,589.75,11.1
"2011","S64  0","S64  0","Total",7610,3769,3841,7610,0,51,639.85,11.9
"2011","S64  5","S64  5","Total",2262,1121,1141,2218,44,12,138.29,16.4
"2011","S64  8","S64  8","Total",12988,6383,6605,12939,49,111,578.67,22.4
"2011","S64  9","S64  9","Total",7836,3825,4011,7684,152,30,263.09,29.8
"2011","S65  1","S65  1","Total",5719,2924,2795,5669,50,27,236.39,24.2
"2011","S65  2","S65  2","Total",13534,6616,6918,13299,235,77,286.73,47.2
"2011","S65  3","S65  3","Total",8754,4266,4488,8754,0,74,560.85,15.6
"2011","S65  4","S65  4","Total",7568,3674,3894,7518,50,45,1680.40,4.5
"2011","S66  1","S66  1","Total",5570,2659,2911,5570,0,100,573.09,9.7
"2011","S66  2","S66  2","Total",9223,4445,4778,9181,42,75,302.47,30.5
"2011","S66  3","S66  3","Total",6772,3371,3401,6699,73,74,289.30,23.4
"2011","S66  7","S66  7","Total",10099,4969,5130,10022,77,70,3352.95,3.0
"2011","S66  8","S66  8","Total",9293,4578,4715,9175,118,86,1883.85,4.9
"2011","S66  9","S66  9","Total",5226,2581,2645,5205,21,31,791.29,6.6
"2011","S7   1","S7   1","Total",9635,5116,4519,9498,137,138,122.97,78.4
"2011","S7   2","S7   2","Total",7801,3806,3995,7785,16,185,267.29,29.2
"2011","S70  1","S70  1","Total",5674,2865,2809,5624,50,31,103.71,54.7
"2011","S70  2","S70  2","Total",1620,853,767,1606,14,12,43.16,37.5
"2011","S70  3","S70  3","Total",7966,3990,3976,7851,115,39,315.19,25.3
"2011","S70  4","S70  4","Total",8132,3976,4156,8027,105,59,493.91,16.5
"2011","S70  5","S70  5","Total",7795,3780,4015,7763,32,40,1020.08,7.6
"2011","S70  6","S70  6","Total",7652,3815,3837,7601,51,62,349.79,21.9
"2011","S71  1","S71  1","Total",8048,4045,4003,8047,1,44,374.62,21.5
"2011","S71  2","S71  2","Total",9076,4438,4638,9024,52,50,457.15,19.9
"2011","S71  3","S71  3","Total",9519,4684,4835,9494,25,47,361.16,26.4
"2011","S71  4","S71  4","Total",10069,4919,5150,10000,69,81,745.06,13.5
"2011","S71  5","S71  5","Total",8180,3984,4196,8048,132,47,702.55,11.6
"2011","S72  0","S72  0","Total",3344,1614,1730,3304,40,19,1292.12,2.6
"2011","S72  7","S72  7","Total",4672,2298,2374,4569,103,23,420.67,11.1
"2011","S72  8","S72  8","Total",12926,6373,6553,12844,82,89,1108.26,11.7
"2011","S72  9","S72  9","Total",4412,2148,2264,4389,23,36,1093.18,4.0
"2011","S73  0","S73  0","Total",11826,5788,6038,11702,124,74,845.71,14.0
"2011","S73  8","S73  8","Total",8327,4109,4218,8301,26,34,370.71,22.5
"2011","S73  9","S73  9","Total",6861,3344,3517,6792,69,56,847.45,8.1
"2011","S74  0","S74  0","Total",7431,3540,3891,7391,40,46,766.19,9.7
"2011","S74  8","S74  8","Total",4148,2069,2079,4148,0,25,228.57,18.1
"2011","S74  9","S74  9","Total",6131,3011,3120,6071,60,34,213.04,28.8
"2011","S75  1","S75  1","Total",7013,3467,3546,7013,0,56,816.09,8.6
"2011","S75  2","S75  2","Total",8657,4247,4410,8569,88,94,239.36,36.2
"2011","S75  3","S75  3","Total",7691,3788,3903,7617,74,74,2018.11,3.8
"2011","S75  4","S75  4","Total",4737,2303,2434,4737,0,79,3222.32,1.5
"2011","S75  5","S75  5","Total",8628,4179,4449,8591,37,89,957.87,9.0
"2011","S75  6","S75  6","Total",6872,3332,3540,6751,121,51,475.00,14.5
"2011","S8   0","S8   0","Total",11060,5444,5616,10890,170,112,329.36,33.6
"2011","S8   7","S8   7","Total",12494,6018,6476,12451,43,107,392.18,31.9
"2011","S8   8","S8   8","Total",12634,6174,6460,12542,92,120,439.23,28.8
"2011","S8   9","S8   9","Total",9986,4934,5052,9876,110,103,255.21,39.1
"2011","S80  1","S80  1","Total",5506,2693,2813,5444,62,50,424.09,13.0
"2011","S80  2","S80  2","Total",9618,4721,4897,9304,314,44,1467.21,6.6
"2011","S80  3","S80  3","Total",4979,2468,2511,4961,18,64,7436.32,0.7
"2011","S80  4","S80  4","Total",9929,4880,5049,9825,104,61,2192.67,4.5
"2011","S81  0","S81  0","Total",11146,5358,5788,11096,50,94,1566.62,7.1
"2011","S81  7","S81  7","Total",10563,5225,5338,10357,206,122,429.10,24.6
"2011","S81  8","S81  8","Total",7707,3813,3894,7668,39,115,5343.13,1.4
"2011","S81  9","S81  9","Total",7928,3835,4093,7887,41,55,2361.11,3.4
"2011","S9   1","S9   1","Total",12124,6028,6096,12073,51,63,834.26,14.5
"2011","S9   3","S9   3","Total",3467,1672,1795,3467,0,14,347.52,10.0
"2011","S9   4","S9   4","Total",8304,4148,4156,8209,95,31,364.47,22.8
"2011","S9   5","S9   5","Total",4194,2155,2039,4193,1,18,325.55,12.9
"2011","SE1  0","SE1  0","Total",4859,2577,2282,3862,997,51,58.04,83.7
"2011","SE1  1","SE1  1","Total",4274,2142,2132,3995,279,28,31.43,136.0
"2011","SE1  2","SE1  2","Total",7893,4286,3607,7709,184,26,55.38,142.5
"2011","SE1  3","SE1  3","Total",8896,4617,4279,8631,265,44,69.43,128.1
"2011","SE1  4","SE1  4","Total",10678,5267,5411,9703,975,90,60.48,176.6
"2011","SE1  5","SE1  5","Total",11349,5659,5690,11322,27,76,83.00,136.7
"2011","SE1  6","SE1  6","Total",6408,3427,2981,6329,79,101,39.53,162.1
"2011","SE1  7","SE1  7","Total",5591,3003,2588,5431,160,58,82.15,68.1
"2011","SE1  8","SE1  8","Total",4070,2093,1977,3704,366,48,39.37,103.4
"2011","SE1  9","SE1  9","Total",3019,1574,1445,2623,396,31,41.16,73.3
"2011","SE10 0","SE10 0","Total",7819,3888,3931,7815,4,62,241.03,32.4
"2011","SE10 8","SE10 8","Total",7517,3793,3724,7453,64,73,175.78,42.8
"2011","SE10 9","SE10 9","Total",8651,4263,4388,8336,315,48,97.35,88.9
"2011","SE11 4","SE11 4","Total",8860,4615,4245,8398,462,95,75.48,117.4
"2011","SE11 5","SE11 5","Total",7300,3795,3505,7300,0,71,74.51,98.0
"2011","SE11 6","SE11 6","Total",5814,2879,2935,5778,36,75,44.79,129.8
"2011","SE12 0","SE12 0","Total",8642,4218,4424,8603,39,71,146.98,58.8
"2011","SE12 8","SE12 8","Total",7958,3895,4063,7958,0,98,143.84,55.3
"2011","SE12 9","SE12 9","Total",10543,5010,5533,10533,10,135,191.21,55.1
"2011","SE13 5","SE13 5","Total",12725,6378,6347,12573,152,118,132.58,96.0
"2011","SE13 6","SE13 6","Total",11961,6035,5926,11824,137,94,123.31,97.0
"2011","SE13 7","SE13 7","Total",17592,8898,8694,17460,132,175,179.65,97.9
"2011","SE14 5","SE14 5","Total",15038,7701,7337,14921,117,181,162.70,92.4
"2011","SE14 6","SE14 6","Total",9641,4720,4921,8745,896,94,102.86,93.7
"2011","SE15 1","SE15 1","Total",7119,3459,3660,7106,13,94,65.96,107.9
"2011","SE15 2","SE15 2","Total",12538,6302,6236,12376,162,122,94.94,132.1
"2011","SE15 3","SE15 3","Total",14373,6895,7478,14261,112,138,158.53,90.7
"2011","SE15 4","SE15 4","Total",8383,4066,4317,8282,101,70,73.85,113.5
"2011","SE15 5","SE15 5","Total",9579,4717,4862,9549,30,107,77.54,123.5
"2011","SE15 6","SE15 6","Total",12367,6007,6360,12313,54,139,88.67,139.5
"2011","SE16 2","SE16 2","Total",10116,4857,5259,9950,166,100,93.59,108.1
"2011","SE16 3","SE16 3","Total",10229,4921,5308,10229,0,91,90.82,112.6
"2011","SE16 4","SE16 4","Total",6665,3347,3318,6661,4,48,52.76,126.3
"2011","SE16 5","SE16 5","Total",6352,3279,3073,6341,11,42,53.29,119.2
"2011","SE16 6","SE16 6","Total",4915,2484,2431,4914,1,49,56.60,86.8
"2011","SE16 7","SE16 7","Total",6680,3400,3280,6662,18,36,85.65,78.0
"2011","SE17 1","SE17 1","Total",7836,3865,3971,7834,2,66,49.92,157.0
"2011","SE17 2","SE17 2","Total",13729,6787,6942,13695,34,143,78.92,174.0
"2011","SE17 3","SE17 3","Total",12026,6009,6017,11881,145,102,72.55,165.8
"2011","SE18 1","SE18 1","Total",14635,7652,6983,14635,0,120,146.28,100.0
"2011","SE18 2","SE18 2","Total",10055,5048,5007,10044,11,82,237.35,42.4
"2011","SE18 3","SE18 3","Total",11788,5827,5961,11730,58,147,225.05,52.4
"2011","SE18 4","SE18 4","Total",7685,3926,3759,7298,387,68,195.07,39.4
"2011","SE18 5","SE18 5","Total",10374,5209,5165,10303,71,88,83.04,124.9
"2011","SE18 6","SE18 6","Total",9766,5074,4692,9766,0,66,110.73,88.2
"2011","SE18 7","SE18 7","Total",13081,6531,6550,12997,84,154,108.13,121.0
"2011","SE19 1","SE19 1","Total",8804,4170,4634,8767,37,87,99.97,88.1
"2011","SE19 2","SE19 2","Total",7789,3889,3900,7719,70,70,167.85,46.4
"2011","SE19 3","SE19 3","Total",11057,5329,5728,10927,130,142,178.68,61.9
"2011","SE2  0","SE2  0","Total",12590,6136,6454,12569,21,128,313.61,40.1
"2011","SE2  9","SE2  9","Total",14514,6902,7612,14431,83,166,193.23,75.1
"2011","SE20 7","SE20 7","Total",11585,5590,5995,11557,28,119,139.68,82.9
"2011","SE20 8","SE20 8","Total",11296,5503,5793,11153,143,91,141.62,79.8
"2011","SE21 7","SE21 7","Total",3902,1960,1942,3738,164,167,252.23,15.5
"2011","SE21 8","SE21 8","Total",11357,5435,5922,11332,25,197,181.68,62.5
"2011","SE22 0","SE22 0","Total",10440,4990,5450,10351,89,123,167.27,62.4
"2011","SE22 8","SE22 8","Total",10659,4992,5667,10627,32,146,132.44,80.5
"2011","SE22 9","SE22 9","Total",8639,4157,4482,8624,15,71,64.20,134.6
"2011","SE23 1","SE23 1","Total",8639,4196,4443,8611,28,80,97.97,88.2
"2011","SE23 2","SE23 2","Total",12961,6458,6503,12916,45,155,138.26,93.7
"2011","SE23 3","SE23 3","Total",11889,5930,5959,11856,33,142,184.94,64.3
"2011","SE24 0","SE24 0","Total",9256,4561,4695,9235,21,109,140.50,65.9
"2011","SE24 9","SE24 9","Total",9658,4657,5001,9638,20,171,127.38,75.8
"2011","SE25 4","SE25 4","Total",12515,5868,6647,12515,0,149,190.89,65.6
"2011","SE25 5","SE25 5","Total",9473,4616,4857,9450,23,79,145.58,65.1
"2011","SE25 6","SE25 6","Total",12698,6134,6564,12611,87,140,151.73,83.7
"2011","SE26 4","SE26 4","Total",9781,4752,5029,9708,73,121,109.11,89.6
"2011","SE26 5","SE26 5","Total",7941,3918,4023,7853,88,71,109.00,72.9
"2011","SE26 6","SE26 6","Total",10656,5044,5612,10480,176,125,170.47,62.5
"2011","SE27 0","SE27 0","Total",12554,6048,6506,12368,186,142,121.10,103.7
"2011","SE27 9","SE27 9","Total",9282,4433,4849,9278,4,131,125.35,74.0
"2011","SE28 0","SE28 0","Total",11234,5947,5287,10341,893,100,233.71,48.1
"2011","SE28 8","SE28 8","Total",18254,8880,9374,18128,126,231,275.67,66.2
"2011","SE3  0","SE3  0","Total",6061,2974,3087,5944,117,94,163.12,37.2
"2011","SE3  7","SE3  7","Total",8652,4260,4392,8558,94,125,123.28,70.2
"2011","SE3  8","SE3  8","Total",9513,4660,4853,9475,38,104,188.02,50.6
"2011","SE3  9","SE3  9","Total",7564,3626,3938,7490,74,121,204.54,37.0
"2011","SE4  1","SE4  1","Total",17285,8409,8876,17026,259,146,207.77,83.2
"2011","SE4  2","SE4  2","Total",11438,5429,6009,11422,16,128,106.97,106.9
"2011","SE5  0","SE5  0","Total",9259,4690,4569,9227,32,98,77.53,119.4
"2011","SE5  7","SE5  7","Total",10806,5285,5521,10549,257,128,84.50,127.9
"2011","SE5  8","SE5  8","Total",14703,7087,7616,14196,507,229,135.29,108.7
"2011","SE5  9","SE5  9","Total",11488,5669,5819,11307,181,133,108.22,106.2
"2011","SE6  1","SE6  1","Total",16764,7889,8875,16647,117,209,211.46,79.3
"2011","SE6  2","SE6  2","Total",13369,6587,6782,13160,209,152,169.55,78.8
"2011","SE6  3","SE6  3","Total",11129,5267,5862,11077,52,109,173.85,64.0
"2011","SE6  4","SE6  4","Total",12009,5977,6032,11951,58,113,170.33,70.5
"2011","SE7  7","SE7  7","Total",12035,5808,6227,11984,51,135,223.73,53.8
"2011","SE7  8","SE7  8","Total",9104,4468,4636,8962,142,75,154.33,59.0
"2011","SE8  3","SE8  3","Total",10520,5253,5267,9795,725,122,93.92,112.0
"2011","SE8  4","SE8  4","Total",7542,3758,3784,7542,0,62,90.29,83.5
"2011","SE8  5","SE8  5","Total",9797,4771,5026,9793,4,131,92.95,105.4
"2011","SE9  1","SE9  1","Total",11716,5721,5995,11709,7,156,241.59,48.5
"2011","SE9  2","SE9  2","Total",10067,4736,5331,8993,1074,86,337.91,29.8
"2011","SE9  3","SE9  3","Total",12849,6289,6560,12739,110,109,249.82,51.4
"2011","SE9  4","SE9  4","Total",12003,5616,6387,11937,66,106,271.95,44.1
"2011","SE9  5","SE9  5","Total",7193,3530,3663,7191,2,49,243.75,29.5
"2011","SE9  6","SE9  6","Total",9024,4413,4611,9024,0,93,162.50,55.5
"2011","SG1  1","SG1  1","Total",7227,3561,3666,7220,7,29,437.68,16.5
"2011","SG1  2","SG1  2","Total",7325,3652,3673,7304,21,92,356.75,20.5
"2011","SG1  3","SG1  3","Total",8240,4074,4166,8184,56,77,205.73,40.1
"2011","SG1  4","SG1  4","Total",10655,5262,5393,10484,171,150,418.89,25.4
"2011","SG1  5","SG1  5","Total",11072,5595,5477,10981,91,97,204.21,54.2
"2011","SG1  6","SG1  6","Total",6731,3414,3317,6731,0,80,118.50,56.8
"2011","SG10 6","SG10 6","Total",2087,987,1100,1914,173,58,1816.09,1.1
"2011","SG11 1","SG11 1","Total",5014,2512,2502,4871,143,81,3684.91,1.4
"2011","SG11 2","SG11 2","Total",2955,1469,1486,2955,0,69,4337.71,0.7
"2011","SG12 0","SG12 0","Total",9464,4746,4718,9433,31,166,4378.08,2.2
"2011","SG12 7","SG12 7","Total",8788,4295,4493,8638,150,126,1501.80,5.9
"2011","SG12 8","SG12 8","Total",6471,3165,3306,6380,91,102,2619.19,2.5
"2011","SG12 9","SG12 9","Total",5344,2600,2744,5248,96,95,459.18,11.6
"2011","SG13 7","SG13 7","Total",10747,5364,5383,10282,465,239,845.07,12.7
"2011","SG13 8","SG13 8","Total",5896,2909,2987,5891,5,168,3712.73,1.6
"2011","SG14 1","SG14 1","Total",2521,1261,1260,2521,0,20,74.39,33.9
"2011","SG14 2","SG14 2","Total",7248,3518,3730,7229,19,128,2196.97,3.3
"2011","SG14 3","SG14 3","Total",9029,4349,4680,8981,48,180,2366.80,3.8
"2011","SG15 6","SG15 6","Total",5584,2765,2819,5522,62,60,948.68,5.9
"2011","SG16 6","SG16 6","Total",6110,3070,3040,5953,157,90,1703.11,3.6
"2011","SG17 5","SG17 5","Total",12203,6034,6169,11868,335,202,2557.13,4.8
"2011","SG18 0","SG18 0","Total",7559,3693,3866,7491,68,65,509.28,14.8
"2011","SG18 8","SG18 8","Total",9688,4794,4894,9656,32,114,2899.16,3.3
"2011","SG18 9","SG18 9","Total",6881,3452,3429,6834,47,92,6119.44,1.1
"2011","SG19 1","SG19 1","Total",9649,4799,4850,9576,73,96,1716.13,5.6
"2011","SG19 2","SG19 2","Total",9422,4675,4747,9416,6,120,6186.82,1.5
"2011","SG19 3","SG19 3","Total",5026,2502,2524,5025,1,92,5613.15,0.9
"2011","SG2  0","SG2  0","Total",8148,4004,4144,8112,36,72,165.44,49.3
"2011","SG2  7","SG2  7","Total",7753,3890,3863,7753,0,152,4197.78,1.8
"2011","SG2  8","SG2  8","Total",12756,6236,6520,12680,76,128,389.00,32.8
"2011","SG2  9","SG2  9","Total",13455,6573,6882,13361,94,144,317.40,42.4
"2011","SG3  6","SG3  6","Total",7068,3458,3610,6979,89,138,2143.63,3.3
"2011","SG4  0","SG4  0","Total",8805,4402,4403,8805,0,127,509.84,17.3
"2011","SG4  7","SG4  7","Total",5109,2428,2681,4900,209,133,5380.40,0.9
"2011","SG4  8","SG4  8","Total",6582,3217,3365,6539,43,151,5128.04,1.3
"2011","SG4  9","SG4  9","Total",8716,4236,4480,8648,68,181,227.67,38.3
"2011","SG5  1","SG5  1","Total",7232,3613,3619,7153,79,105,248.62,29.1
"2011","SG5  2","SG5  2","Total",8205,3983,4222,8077,128,114,555.48,14.8
"2011","SG5  3","SG5  3","Total",6338,3132,3206,6317,21,102,5846.05,1.1
"2011","SG5  4","SG5  4","Total",9632,4735,4897,9632,0,95,1162.80,8.3
"2011","SG6  1","SG6  1","Total",7167,3453,3714,7055,112,76,452.38,15.8
"2011","SG6  2","SG6  2","Total",7802,3823,3979,7716,86,126,590.44,13.2
"2011","SG6  3","SG6  3","Total",6125,2922,3203,5971,154,153,422.23,14.5
"2011","SG6  4","SG6  4","Total",12155,5873,6282,12155,0,127,546.14,22.3
"2011","SG7  5","SG7  5","Total",4406,2138,2268,4361,45,90,3866.92,1.1
"2011","SG7  6","SG7  6","Total",8870,4427,4443,8724,146,140,2482.41,3.6
"2011","SG8  0","SG8  0","Total",4070,2009,2061,4069,1,86,7046.23,0.6
"2011","SG8  5","SG8  5","Total",10627,5305,5322,10358,269,194,4265.32,2.5
"2011","SG8  6","SG8  6","Total",7240,3515,3725,7095,145,145,3278.36,2.2
"2011","SG8  7","SG8  7","Total",7620,3800,3820,7582,38,104,2168.69,3.5
"2011","SG8  8","SG8  8","Total",3365,1639,1726,3348,17,92,6777.44,0.5
"2011","SG8  9","SG8  9","Total",5355,2669,2686,5343,12,105,3078.14,1.7
"2011","SG9  0","SG9  0","Total",3220,1629,1591,3220,0,108,8125.82,0.4
"2011","SG9  9","SG9  9","Total",6154,3032,3122,6101,53,111,3515.75,1.8
"2011","SK1  2","SK1  2","Total",1635,815,820,1635,0,7,84.80,19.3
"2011","SK1  3","SK1  3","Total",2495,1388,1107,2418,77,11,134.82,18.5
"2011","SK1  4","SK1  4","Total",7420,3660,3760,7372,48,48,177.99,41.7
"2011","SK10 1","SK10 1","Total",3206,1542,1664,3191,15,42,123.04,26.1
"2011","SK10 2","SK10 2","Total",10749,5330,5419,10745,4,236,630.83,17.0
"2011","SK10 3","SK10 3","Total",10347,5046,5301,10126,221,223,489.62,21.1
"2011","SK10 4","SK10 4","Total",6390,3063,3327,6217,173,229,5599.62,1.1
"2011","SK10 5","SK10 5","Total",9112,4486,4626,9024,88,154,3596.19,2.5
"2011","SK11 0","SK11 0","Total",4208,2077,2131,4116,92,75,10420.59,0.4
"2011","SK11 6","SK11 6","Total",3687,1868,1819,3687,0,43,60.91,60.5
"2011","SK11 7","SK11 7","Total",11697,5708,5989,11568,129,139,560.13,20.9
"2011","SK11 8","SK11 8","Total",12796,6180,6616,12660,136,169,301.81,42.4
"2011","SK11 9","SK11 9","Total",4159,2052,2107,4159,0,95,7368.27,0.6
"2011","SK12 1","SK12 1","Total",14260,6922,7338,14125,135,300,1201.08,11.9
"2011","SK12 2","SK12 2","Total",4812,2348,2464,4738,74,93,2448.16,2.0
"2011","SK13 0","SK13 0","Total",1943,925,1018,1943,0,15,76.79,25.3
"2011","SK13 1","SK13 1","Total",6899,3363,3536,6818,81,82,5014.22,1.4
"2011","SK13 2","SK13 2","Total",3700,1812,1888,3663,37,37,167.42,22.1
"2011","SK13 5","SK13 5","Total",1437,697,740,1437,0,32,817.63,1.8
"2011","SK13 6","SK13 6","Total",6113,3034,3079,6058,55,94,264.20,23.1
"2011","SK13 7","SK13 7","Total",3872,1874,1998,3842,30,68,5935.53,0.7
"2011","SK13 8","SK13 8","Total",9126,4502,4624,9090,36,117,326.88,27.9
"2011","SK14 1","SK14 1","Total",5911,2935,2976,5854,57,29,118.97,49.7
"2011","SK14 2","SK14 2","Total",4141,2034,2107,4074,67,33,120.08,34.5
"2011","SK14 3","SK14 3","Total",6487,3154,3333,6487,0,50,799.54,8.1
"2011","SK14 4","SK14 4","Total",12573,6162,6411,12529,44,81,386.97,32.5
"2011","SK14 5","SK14 5","Total",9854,4741,5113,9699,155,84,341.73,28.8
"2011","SK14 6","SK14 6","Total",4389,2167,2222,4375,14,45,498.55,8.8
"2011","SK14 8","SK14 8","Total",2878,1423,1455,2866,12,32,405.71,7.1
"2011","SK15 1","SK15 1","Total",8991,4460,4531,8867,124,48,267.96,33.6
"2011","SK15 2","SK15 2","Total",9184,4562,4622,9146,38,124,483.10,19.0
"2011","SK15 3","SK15 3","Total",9249,4552,4697,9179,70,85,1760.99,5.3
"2011","SK16 4","SK16 4","Total",8400,4149,4251,8335,65,45,276.62,30.4
"2011","SK16 5","SK16 5","Total",11245,5538,5707,11125,120,70,287.89,39.1
"2011","SK17 0","SK17 0","Total",2935,1461,1474,2902,33,31,14229.82,0.2
"2011","SK17 6","SK17 6","Total",8296,4092,4204,7818,478,156,1452.74,5.7
"2011","SK17 7","SK17 7","Total",7427,3622,3805,7399,28,70,1061.82,7.0
"2011","SK17 8","SK17 8","Total",5515,2808,2707,5512,3,81,9230.44,0.6
"2011","SK17 9","SK17 9","Total",8034,3973,4061,7989,45,145,9360.81,0.9
"2011","SK2  5","SK2  5","Total",14129,6906,7223,14054,75,146,468.45,30.2
"2011","SK2  6","SK2  6","Total",7566,3801,3765,7446,120,78,147.48,51.3
"2011","SK2  7","SK2  7","Total",7214,3563,3651,7151,63,88,218.46,33.0
"2011","SK22 1","SK22 1","Total",1127,551,576,1127,0,23,1489.65,0.8
"2011","SK22 2","SK22 2","Total",2381,1186,1195,2377,4,40,3114.03,0.8
"2011","SK22 3","SK22 3","Total",3077,1545,1532,3075,2,55,427.83,7.2
"2011","SK22 4","SK22 4","Total",5645,2778,2867,5556,89,58,273.87,20.6
"2011","SK23 0","SK23 0","Total",4579,2243,2336,4566,13,67,1432.25,3.2
"2011","SK23 6","SK23 6","Total",2142,1066,1076,2135,7,44,1251.53,1.7
"2011","SK23 7","SK23 7","Total",7873,3934,3939,7865,8,120,2698.27,2.9
"2011","SK23 9","SK23 9","Total",2531,1216,1315,2427,104,40,1432.62,1.8
"2011","SK3  0","SK3  0","Total",7081,3499,3582,7028,53,47,191.20,37.0
"2011","SK3  8","SK3  8","Total",12530,6059,6471,12326,204,135,251.52,49.8
"2011","SK3  9","SK3  9","Total",8776,4247,4529,8736,40,35,148.11,59.3
"2011","SK4  1","SK4  1","Total",3645,1851,1794,3559,86,15,103.73,35.1
"2011","SK4  2","SK4  2","Total",7980,3901,4079,7919,61,121,230.93,34.6
"2011","SK4  3","SK4  3","Total",8354,4092,4262,8289,65,136,238.19,35.1
"2011","SK4  4","SK4  4","Total",7543,3723,3820,7354,189,160,189.11,39.9
"2011","SK4  5","SK4  5","Total",7282,3575,3707,7237,45,94,168.44,43.2
"2011","SK5  6","SK5  6","Total",13968,6767,7201,13968,0,91,234.92,59.5
"2011","SK5  7","SK5  7","Total",8222,4069,4153,8221,1,66,273.48,30.1
"2011","SK5  8","SK5  8","Total",6964,3416,3548,6885,79,26,216.83,32.1
"2011","SK6  1","SK6  1","Total",9330,4647,4683,9301,29,83,294.40,31.7
"2011","SK6  2","SK6  2","Total",7055,3431,3624,6924,131,54,410.85,17.2
"2011","SK6  3","SK6  3","Total",4718,2268,2450,4674,44,36,299.43,15.8
"2011","SK6  4","SK6  4","Total",6629,3253,3376,6617,12,80,462.88,14.3
"2011","SK6  5","SK6  5","Total",5792,2815,2977,5773,19,122,1917.59,3.0
"2011","SK6  6","SK6  6","Total",6588,3148,3440,6460,128,115,442.03,14.9
"2011","SK6  7","SK6  7","Total",6873,3275,3598,6717,156,63,529.73,13.0
"2011","SK6  8","SK6  8","Total",3828,1857,1971,3811,17,45,287.89,13.3
"2011","SK7  1","SK7  1","Total",6761,3264,3497,6652,109,159,794.88,8.5
"2011","SK7  2","SK7  2","Total",7106,3401,3705,7008,98,203,373.47,19.0
"2011","SK7  3","SK7  3","Total",6678,3243,3435,6651,27,178,308.35,21.7
"2011","SK7  4","SK7  4","Total",7388,3590,3798,7381,7,85,192.31,38.4
"2011","SK7  5","SK7  5","Total",5876,2864,3012,5866,10,109,242.73,24.2
"2011","SK7  6","SK7  6","Total",6645,3237,3408,6578,67,120,472.08,14.1
"2011","SK8  1","SK8  1","Total",5536,2624,2912,5489,47,101,355.81,15.6
"2011","SK8  2","SK8  2","Total",6923,3312,3611,6923,0,41,154.30,44.9
"2011","SK8  3","SK8  3","Total",12440,6111,6329,12314,126,161,440.96,28.2
"2011","SK8  4","SK8  4","Total",8557,4127,4430,8472,85,137,289.62,29.5
"2011","SK8  5","SK8  5","Total",8382,4154,4228,8380,2,112,241.98,34.6
"2011","SK8  6","SK8  6","Total",7783,3763,4020,7779,4,167,301.18,25.8
"2011","SK8  7","SK8  7","Total",8725,4282,4443,8713,12,232,262.18,33.3
"2011","SK9  1","SK9  1","Total",2340,1140,1200,2336,4,61,176.85,13.2
"2011","SK9  2","SK9  2","Total",8953,4450,4503,8894,59,215,823.42,10.9
"2011","SK9  3","SK9  3","Total",6266,3089,3177,6249,17,93,445.02,14.1
"2011","SK9  4","SK9  4","Total",4067,1839,2228,3655,412,66,550.56,7.4
"2011","SK9  5","SK9  5","Total",5052,2419,2633,5017,35,129,731.54,6.9
"2011","SK9  6","SK9  6","Total",5285,2591,2694,5285,0,138,236.22,22.4
"2011","SK9  7","SK9  7","Total",6038,2903,3135,5714,324,164,1697.57,3.6
"2011","SL0  0","SL0  0","Total",5578,2771,2807,5573,5,90,984.80,5.7
"2011","SL0  9","SL0  9","Total",5541,2751,2790,5499,42,103,1024.45,5.4
"2011","SL1  1","SL1  1","Total",5761,3037,2724,5756,5,62,103.50,55.7
"2011","SL1  2","SL1  2","Total",16380,8479,7901,16205,175,149,260.68,62.8
"2011","SL1  3","SL1  3","Total",15764,7947,7817,15711,53,127,237.59,66.3
"2011","SL1  4","SL1  4","Total",447,240,207,447,0,4,12.39,36.1
"2011","SL1  5","SL1  5","Total",13811,6868,6943,13789,22,115,380.37,36.3
"2011","SL1  6","SL1  6","Total",7377,3593,3784,7365,12,83,171.44,43.0
"2011","SL1  7","SL1  7","Total",5263,2481,2782,5263,0,83,169.89,31.0
"2011","SL1  8","SL1  8","Total",3469,1659,1810,3395,74,74,1037.30,3.3
"2011","SL1  9","SL1  9","Total",2532,1292,1240,2532,0,27,49.04,51.6
"2011","SL2  1","SL2  1","Total",15252,7571,7681,15241,11,140,319.23,47.8
"2011","SL2  2","SL2  2","Total",7898,3858,4040,7897,1,60,136.44,57.9
"2011","SL2  3","SL2  3","Total",7167,3446,3721,6968,199,215,1656.66,4.3
"2011","SL2  4","SL2  4","Total",5472,2630,2842,5334,138,101,1518.83,3.6
"2011","SL2  5","SL2  5","Total",17501,8714,8787,17427,74,165,288.53,60.7
"2011","SL3  0","SL3  0","Total",3914,2009,1905,3912,2,35,510.64,7.7
"2011","SL3  6","SL3  6","Total",3023,1417,1606,2908,115,47,1203.40,2.5
"2011","SL3  7","SL3  7","Total",14979,7320,7659,14950,29,295,366.66,40.9
"2011","SL3  8","SL3  8","Total",17315,8684,8631,17315,0,179,334.66,51.7
"2011","SL3  9","SL3  9","Total",5932,2925,3007,5899,33,107,994.25,6.0
"2011","SL4  1","SL4  1","Total",3184,1663,1521,2970,214,35,92.64,34.4
"2011","SL4  2","SL4  2","Total",6578,3220,3358,6491,87,156,3654.17,1.8
"2011","SL4  3","SL4  3","Total",8767,4342,4425,8403,364,147,175.75,49.9
"2011","SL4  4","SL4  4","Total",10503,5095,5408,10496,7,218,1814.90,5.8
"2011","SL4  5","SL4  5","Total",9345,4611,4734,9269,76,136,353.78,26.4
"2011","SL4  6","SL4  6","Total",4970,2897,2073,3966,1004,92,894.77,5.6
"2011","SL5  0","SL5  0","Total",3783,1817,1966,3707,76,99,800.99,4.7
"2011","SL5  7","SL5  7","Total",5397,2618,2779,4973,424,164,679.96,7.9
"2011","SL5  8","SL5  8","Total",7203,3417,3786,6770,433,166,1729.12,4.2
"2011","SL5  9","SL5  9","Total",7487,3467,4020,7016,471,258,585.86,12.8
"2011","SL6  0","SL6  0","Total",4814,2331,2483,4767,47,85,1419.78,3.4
"2011","SL6  1","SL6  1","Total",5036,2543,2493,4993,43,100,210.45,23.9
"2011","SL6  2","SL6  2","Total",10716,5276,5440,10538,178,187,1621.92,6.6
"2011","SL6  3","SL6  3","Total",11158,5488,5670,11085,73,219,3027.64,3.7
"2011","SL6  4","SL6  4","Total",7725,3837,3888,7713,12,170,299.73,25.8
"2011","SL6  5","SL6  5","Total",6804,3281,3523,6694,110,160,559.03,12.2
"2011","SL6  6","SL6  6","Total",9567,4646,4921,9476,91,239,1459.03,6.6
"2011","SL6  7","SL6  7","Total",9409,4601,4808,9386,23,132,186.86,50.4
"2011","SL6  8","SL6  8","Total",6501,3212,3289,6415,86,133,390.64,16.6
"2011","SL6  9","SL6  9","Total",6107,2993,3114,6017,90,154,1620.72,3.8
"2011","SL7  1","SL7  1","Total",7292,3493,3799,7255,37,135,506.55,14.4
"2011","SL7  2","SL7  2","Total",5543,2708,2835,5487,56,218,2546.49,2.2
"2011","SL7  3","SL7  3","Total",8111,4007,4104,8084,27,156,1982.00,4.1
"2011","SL8  5","SL8  5","Total",6448,3121,3327,6384,64,154,619.79,10.4
"2011","SL9  0","SL9  0","Total",5190,2517,2673,4980,210,172,838.15,6.2
"2011","SL9  7","SL9  7","Total",5400,2606,2794,5344,56,220,754.76,7.2
"2011","SL9  8","SL9  8","Total",4463,2147,2316,4324,139,205,486.76,9.2
"2011","SL9  9","SL9  9","Total",5730,2672,3058,5651,79,122,618.97,9.3
"2011","SM1  1","SM1  1","Total",2530,1227,1303,2509,21,18,45.16,56.0
"2011","SM1  2","SM1  2","Total",13885,6757,7128,13804,81,168,216.02,64.3
"2011","SM1  3","SM1  3","Total",11734,5686,6048,11557,177,140,210.45,55.8
"2011","SM1  4","SM1  4","Total",9913,4894,5019,9884,29,96,113.93,87.0
"2011","SM2  5","SM2  5","Total",12174,6157,6017,11130,1044,171,357.42,34.1
"2011","SM2  6","SM2  6","Total",9810,4771,5039,9535,275,113,148.69,66.0
"2011","SM2  7","SM2  7","Total",5704,2752,2952,5596,108,200,268.59,21.2
"2011","SM3  8","SM3  8","Total",7513,3634,3879,7438,75,148,155.79,48.2
"2011","SM3  9","SM3  9","Total",13505,6640,6865,13505,0,193,241.00,56.0
"2011","SM4  4","SM4  4","Total",14514,7228,7286,14469,45,202,284.67,51.0
"2011","SM4  5","SM4  5","Total",9248,4626,4622,9207,41,92,192.22,48.1
"2011","SM4  6","SM4  6","Total",13079,6423,6656,13051,28,98,200.46,65.2
"2011","SM5  1","SM5  1","Total",13233,6282,6951,13233,0,71,178.81,74.0
"2011","SM5  2","SM5  2","Total",11208,5450,5758,11208,0,90,178.56,62.8
"2011","SM5  3","SM5  3","Total",7858,3839,4019,7793,65,178,172.27,45.6
"2011","SM5  4","SM5  4","Total",6383,3074,3309,6307,76,165,605.04,10.5
"2011","SM6  0","SM6  0","Total",6159,2901,3258,6004,155,90,112.01,55.0
"2011","SM6  7","SM6  7","Total",6455,3111,3344,6424,31,70,126.25,51.1
"2011","SM6  8","SM6  8","Total",11533,5586,5947,11500,33,149,248.89,46.3
"2011","SM6  9","SM6  9","Total",12347,5959,6388,12314,33,188,265.46,46.5
"2011","SM7  1","SM7  1","Total",6858,3368,3490,6779,79,164,389.16,17.6
"2011","SM7  2","SM7  2","Total",6891,3190,3701,6622,269,120,231.24,29.8
"2011","SM7  3","SM7  3","Total",4514,2128,2386,4280,234,88,539.91,8.4
"2011","SN1  1","SN1  1","Total",783,429,354,783,0,2,15.09,51.9
"2011","SN1  2","SN1  2","Total",9119,4927,4192,9061,58,75,215.32,42.4
"2011","SN1  3","SN1  3","Total",6107,3219,2888,5963,144,52,100.36,60.9
"2011","SN1  4","SN1  4","Total",7426,3866,3560,7169,257,122,234.59,31.7
"2011","SN1  5","SN1  5","Total",5383,2965,2418,5350,33,19,85.18,63.2
"2011","SN1  7","SN1  7","Total",847,409,438,847,0,11,47.70,17.8
"2011","SN10 1","SN10 1","Total",3942,1862,2080,3896,46,57,1214.09,3.2
"2011","SN10 2","SN10 2","Total",6430,3141,3289,6287,143,121,3133.11,2.1
"2011","SN10 3","SN10 3","Total",7604,3681,3923,7587,17,141,8345.01,0.9
"2011","SN10 4","SN10 4","Total",5268,2585,2683,4840,428,148,5833.22,0.9
"2011","SN10 5","SN10 5","Total",8300,4190,4110,7920,380,179,3906.64,2.1
"2011","SN11 0","SN11 0","Total",6041,2816,3225,5704,337,96,2762.59,2.2
"2011","SN11 8","SN11 8","Total",7377,3583,3794,7366,11,92,5701.95,1.3
"2011","SN11 9","SN11 9","Total",8940,4417,4523,8811,129,122,1830.84,4.9
"2011","SN12 6","SN12 6","Total",9714,4820,4894,9694,20,137,1828.30,5.3
"2011","SN12 7","SN12 7","Total",9761,4774,4987,9664,97,114,2071.33,4.7
"2011","SN12 8","SN12 8","Total",5736,2768,2968,5534,202,69,2378.95,2.4
"2011","SN13 0","SN13 0","Total",4756,2291,2465,4679,77,83,716.06,6.6
"2011","SN13 8","SN13 8","Total",2524,1228,1296,2486,38,68,1776.04,1.4
"2011","SN13 9","SN13 9","Total",9249,4442,4807,9155,94,184,2054.72,4.5
"2011","SN14 0","SN14 0","Total",12717,6216,6501,12674,43,192,299.26,42.5
"2011","SN14 6","SN14 6","Total",7400,3731,3669,7101,299,187,7946.16,0.9
"2011","SN14 7","SN14 7","Total",2761,1366,1395,2751,10,77,4864.34,0.6
"2011","SN14 8","SN14 8","Total",5205,2702,2503,4913,292,116,6166.52,0.8
"2011","SN15 1","SN15 1","Total",6720,3307,3413,6649,71,89,249.05,27.0
"2011","SN15 2","SN15 2","Total",5081,2544,2537,4877,204,107,3575.20,1.4
"2011","SN15 3","SN15 3","Total",11587,5785,5802,11461,126,236,1788.02,6.5
"2011","SN15 4","SN15 4","Total",8219,4228,3991,7637,582,179,7031.67,1.2
"2011","SN15 5","SN15 5","Total",3502,1723,1779,3460,42,92,4914.29,0.7
"2011","SN16 0","SN16 0","Total",5989,2917,3072,5886,103,124,6175.82,1.0
"2011","SN16 9","SN16 9","Total",7842,3936,3906,7823,19,238,9203.61,0.9
"2011","SN2  1","SN2  1","Total",13492,6674,6818,13492,0,98,283.67,47.6
"2011","SN2  2","SN2  2","Total",10816,5570,5246,10799,17,61,480.81,22.5
"2011","SN2  5","SN2  5","Total",5824,2795,3029,5824,0,13,116.98,49.8
"2011","SN2  7","SN2  7","Total",8746,4279,4467,8721,25,75,301.32,29.0
"2011","SN2  8","SN2  8","Total",2270,1189,1081,2268,2,10,111.36,20.4
"2011","SN25 1","SN25 1","Total",9952,4993,4959,9919,33,93,262.89,37.9
"2011","SN25 2","SN25 2","Total",9693,4891,4802,9693,0,59,221.91,43.7
"2011","SN25 3","SN25 3","Total",7562,3685,3877,7542,20,43,190.31,39.7
"2011","SN25 4","SN25 4","Total",7998,3982,4016,7998,0,78,228.13,35.1
"2011","SN26 7","SN26 7","Total",1537,750,787,1492,45,18,651.90,2.4
"2011","SN26 8","SN26 8","Total",290,150,140,290,0,7,866.46,0.3
"2011","SN3  1","SN3  1","Total",7725,3745,3980,7699,26,118,461.20,16.7
"2011","SN3  2","SN3  2","Total",11009,5316,5693,10941,68,63,182.72,60.3
"2011","SN3  3","SN3  3","Total",8666,4287,4379,8661,5,57,270.35,32.1
"2011","SN3  4","SN3  4","Total",12638,6180,6458,12446,192,130,1288.54,9.8
"2011","SN3  5","SN3  5","Total",4476,2233,2243,4476,0,41,106.94,41.9
"2011","SN3  6","SN3  6","Total",6603,3284,3319,6574,29,67,181.97,36.3
"2011","SN4  0","SN4  0","Total",7884,3889,3995,7656,228,162,6945.61,1.1
"2011","SN4  7","SN4  7","Total",6796,3343,3453,6743,53,137,4481.57,1.5
"2011","SN4  8","SN4  8","Total",6406,3143,3263,6332,74,146,2163.57,3.0
"2011","SN4  9","SN4  9","Total",6542,3170,3372,6476,66,103,5731.70,1.1
"2011","SN5  0","SN5  0","Total",374,184,190,312,62,6,2119.74,0.2
"2011","SN5  3","SN5  3","Total",1029,511,518,1029,0,31,284.09,3.6
"2011","SN5  4","SN5  4","Total",3897,1869,2028,3805,92,76,1303.42,3.0
"2011","SN5  5","SN5  5","Total",8866,4400,4466,8866,0,173,309.84,28.6
"2011","SN5  6","SN5  6","Total",4811,2403,2408,4811,0,93,162.12,29.7
"2011","SN5  7","SN5  7","Total",3667,1875,1792,3665,2,52,141.34,25.9
"2011","SN5  8","SN5  8","Total",10357,5161,5196,10357,0,95,337.28,30.7
"2011","SN6  6","SN6  6","Total",6975,3429,3546,6925,50,176,6668.14,1.0
"2011","SN6  7","SN6  7","Total",8881,4317,4564,8834,47,132,5411.59,1.6
"2011","SN6  8","SN6  8","Total",5305,2679,2626,5125,180,212,5029.29,1.1
"2011","SN7  7","SN7  7","Total",9091,4458,4633,9005,86,205,7221.99,1.3
"2011","SN7  8","SN7  8","Total",4393,2174,2219,4352,41,130,7735.79,0.6
"2011","SN8  1","SN8  1","Total",6804,3380,3424,6030,774,203,8477.08,0.8
"2011","SN8  2","SN8  2","Total",6121,3009,3112,6019,102,185,10148.55,0.6
"2011","SN8  3","SN8  3","Total",6890,3388,3502,6794,96,201,17291.87,0.4
"2011","SN8  4","SN8  4","Total",4203,1972,2231,4127,76,95,7096.08,0.6
"2011","SN9  5","SN9  5","Total",5005,2398,2607,4957,48,131,5768.37,0.9
"2011","SN9  6","SN9  6","Total",3125,1538,1587,3110,15,108,9071.01,0.3
"2011","SO14 0","SO14 0","Total",7763,4337,3426,7397,366,60,93.51,83.0
"2011","SO14 1","SO14 1","Total",3463,1893,1570,2728,735,45,50.86,68.1
"2011","SO14 2","SO14 2","Total",1150,622,528,1150,0,10,65.59,17.5
"2011","SO14 3","SO14 3","Total",6332,3549,2783,4834,1498,81,133.34,47.5
"2011","SO14 5","SO14 5","Total",2508,1277,1231,2508,0,6,61.59,40.7
"2011","SO14 6","SO14 6","Total",5988,3203,2785,5920,68,36,55.84,107.2
"2011","SO14 7","SO14 7","Total",247,166,81,164,83,2,36.97,6.7
"2011","SO15 0","SO15 0","Total",1233,678,555,1233,0,2,23.07,53.4
"2011","SO15 1","SO15 1","Total",1618,858,760,1596,22,2,137.04,11.8
"2011","SO15 2","SO15 2","Total",10023,5313,4710,9277,746,110,109.95,91.2
"2011","SO15 3","SO15 3","Total",6986,3587,3399,6986,0,38,84.48,82.7
"2011","SO15 4","SO15 4","Total",3154,1533,1621,3154,0,27,79.30,39.8
"2011","SO15 5","SO15 5","Total",12549,6354,6195,12360,189,155,223.17,56.2
"2011","SO15 7","SO15 7","Total",2930,1427,1503,2930,0,65,113.30,25.9
"2011","SO15 8","SO15 8","Total",3619,1790,1829,3548,71,19,174.74,20.7
"2011","SO16 0","SO16 0","Total",1529,733,796,1529,0,21,549.23,2.8
"2011","SO16 2","SO16 2","Total",821,425,396,821,0,10,30.20,27.2
"2011","SO16 3","SO16 3","Total",11168,5729,5439,9128,2040,128,205.83,54.3
"2011","SO16 4","SO16 4","Total",7223,3446,3777,7163,60,36,102.35,70.6
"2011","SO16 5","SO16 5","Total",7542,3691,3851,7542,0,50,122.86,61.4
"2011","SO16 6","SO16 6","Total",7301,3625,3676,7264,37,50,174.86,41.8
"2011","SO16 7","SO16 7","Total",6206,3112,3094,6082,124,140,1297.21,4.8
"2011","SO16 8","SO16 8","Total",12358,6058,6300,12323,35,122,806.46,15.3
"2011","SO16 9","SO16 9","Total",11770,5643,6127,11770,0,49,361.91,32.5
"2011","SO17 1","SO17 1","Total",6840,3486,3354,6594,246,121,158.60,43.1
"2011","SO17 2","SO17 2","Total",7729,4024,3705,7613,116,39,96.28,80.3
"2011","SO17 3","SO17 3","Total",4753,2605,2148,4753,0,46,63.59,74.7
"2011","SO18 1","SO18 1","Total",8209,4212,3997,8149,60,81,167.35,49.1
"2011","SO18 2","SO18 2","Total",10462,5173,5289,8868,1594,78,266.84,39.2
"2011","SO18 3","SO18 3","Total",4203,2060,2143,4203,0,48,89.09,47.2
"2011","SO18 4","SO18 4","Total",4138,1969,2169,4111,27,45,77.22,53.6
"2011","SO18 5","SO18 5","Total",7714,3751,3963,7675,39,57,154.32,50.0
"2011","SO18 6","SO18 6","Total",2264,1079,1185,2264,0,15,44.90,50.4
"2011","SO19 0","SO19 0","Total",3784,1803,1981,3784,0,30,79.67,47.5
"2011","SO19 1","SO19 1","Total",2947,1433,1514,2947,0,13,53.23,55.4
"2011","SO19 2","SO19 2","Total",6233,3088,3145,6198,35,22,95.30,65.4
"2011","SO19 4","SO19 4","Total",1969,1002,967,1967,2,28,44.11,44.6
"2011","SO19 5","SO19 5","Total",1560,775,785,1560,0,12,39.63,39.4
"2011","SO19 6","SO19 6","Total",9244,4450,4794,9218,26,26,184.62,50.1
"2011","SO19 7","SO19 7","Total",7433,3669,3764,7387,46,45,160.16,46.4
"2011","SO19 8","SO19 8","Total",8190,4065,4125,8166,24,55,151.68,54.0
"2011","SO19 9","SO19 9","Total",14982,7275,7707,14780,202,62,319.28,46.9
"2011","SO20 6","SO20 6","Total",4346,2124,2222,4330,16,150,9935.63,0.4
"2011","SO20 8","SO20 8","Total",3735,1923,1812,3510,225,132,4864.04,0.8
"2011","SO21 1","SO21 1","Total",7285,3530,3755,7250,35,199,8354.93,0.9
"2011","SO21 2","SO21 2","Total",6172,3114,3058,5746,426,240,7853.29,0.8
"2011","SO21 3","SO21 3","Total",6100,2987,3113,6073,27,169,10355.10,0.6
"2011","SO22 4","SO22 4","Total",11717,5485,6232,11186,531,230,382.73,30.6
"2011","SO22 5","SO22 5","Total",7831,3842,3989,6679,1152,242,337.86,23.2
"2011","SO22 6","SO22 6","Total",9063,4357,4706,8750,313,235,669.09,13.5
"2011","SO23 0","SO23 0","Total",5490,2521,2969,5233,257,83,297.88,18.4
"2011","SO23 7","SO23 7","Total",9186,4314,4872,8552,634,199,1838.05,5.0
"2011","SO23 8","SO23 8","Total",2740,1322,1418,2641,99,20,58.06,47.2
"2011","SO23 9","SO23 9","Total",4948,2740,2208,4140,808,209,316.25,15.6
"2011","SO24 0","SO24 0","Total",4264,2096,2168,4167,97,167,10557.29,0.4
"2011","SO24 9","SO24 9","Total",7060,3383,3677,7026,34,221,7267.98,1.0
"2011","SO30 0","SO30 0","Total",6658,3234,3424,6590,68,54,154.05,43.2
"2011","SO30 2","SO30 2","Total",13627,6610,7017,13464,163,150,1552.48,8.8
"2011","SO30 3","SO30 3","Total",6124,2979,3145,6032,92,81,1000.58,6.1
"2011","SO30 4","SO30 4","Total",5869,2834,3035,5726,143,63,311.44,18.8
"2011","SO31 1","SO31 1","Total",1743,875,868,1743,0,19,204.94,8.5
"2011","SO31 4","SO31 4","Total",4695,2375,2320,4695,0,38,335.23,14.0
"2011","SO31 5","SO31 5","Total",6338,3068,3270,6248,90,51,549.93,11.5
"2011","SO31 6","SO31 6","Total",11326,5536,5790,11266,60,183,263.81,42.9
"2011","SO31 7","SO31 7","Total",6846,3319,3527,6625,221,128,667.11,10.3
"2011","SO31 8","SO31 8","Total",6955,3371,3584,6928,27,70,673.21,10.3
"2011","SO31 9","SO31 9","Total",6830,3462,3368,6604,226,118,850.04,8.0
"2011","SO32 1","SO32 1","Total",7386,3518,3868,7321,65,150,3211.82,2.3
"2011","SO32 2","SO32 2","Total",9502,4644,4858,9384,118,249,3833.60,2.5
"2011","SO32 3","SO32 3","Total",2864,1390,1474,2845,19,114,6285.57,0.5
"2011","SO40 2","SO40 2","Total",9306,4552,4754,8997,309,95,2540.46,3.7
"2011","SO40 3","SO40 3","Total",7229,3580,3649,7167,62,57,279.96,25.8
"2011","SO40 4","SO40 4","Total",6141,3076,3065,6022,119,82,814.54,7.5
"2011","SO40 7","SO40 7","Total",5375,2633,2742,5243,132,69,996.37,5.4
"2011","SO40 8","SO40 8","Total",8227,4081,4146,8221,6,87,191.39,43.0
"2011","SO40 9","SO40 9","Total",5577,2676,2901,5541,36,58,431.68,12.9
"2011","SO41 0","SO41 0","Total",9898,4635,5263,9804,94,115,1774.53,5.6
"2011","SO41 3","SO41 3","Total",2730,1259,1471,2694,36,48,125.77,21.7
"2011","SO41 5","SO41 5","Total",1421,732,689,1358,63,40,1801.45,0.8
"2011","SO41 6","SO41 6","Total",3644,1715,1929,3507,137,84,1427.89,2.6
"2011","SO41 8","SO41 8","Total",7110,3384,3726,6970,140,117,1836.34,3.9
"2011","SO41 9","SO41 9","Total",6585,3035,3550,6556,29,70,257.58,25.6
"2011","SO42 7","SO42 7","Total",5273,2566,2707,5062,211,121,16626.78,0.3
"2011","SO43 7","SO43 7","Total",4391,2128,2263,4191,200,78,8399.07,0.5
"2011","SO45 1","SO45 1","Total",7879,3847,4032,7826,53,81,3415.19,2.3
"2011","SO45 2","SO45 2","Total",6582,3186,3396,6582,0,39,319.83,20.6
"2011","SO45 3","SO45 3","Total",4736,2281,2455,4700,36,35,168.53,28.1
"2011","SO45 4","SO45 4","Total",5362,2657,2705,5324,38,88,150.29,35.7
"2011","SO45 5","SO45 5","Total",6965,3352,3613,6963,2,65,727.79,9.6
"2011","SO45 6","SO45 6","Total",3463,1647,1816,3458,5,16,211.05,16.4
"2011","SO50 4","SO50 4","Total",9080,4560,4520,9066,14,98,341.48,26.6
"2011","SO50 5","SO50 5","Total",10176,5055,5121,10154,22,43,727.03,14.0
"2011","SO50 6","SO50 6","Total",6202,3046,3156,6169,33,61,611.13,10.1
"2011","SO50 7","SO50 7","Total",8008,4046,3962,7960,48,105,1100.56,7.3
"2011","SO50 8","SO50 8","Total",6741,3333,3408,6735,6,66,309.44,21.8
"2011","SO50 9","SO50 9","Total",6183,3076,3107,6112,71,35,187.32,33.0
"2011","SO51 0","SO51 0","Total",4169,2096,2073,3972,197,126,6389.59,0.7
"2011","SO51 5","SO51 5","Total",4093,1963,2130,4072,21,68,527.80,7.8
"2011","SO51 6","SO51 6","Total",4535,2215,2320,4336,199,103,3788.25,1.2
"2011","SO51 7","SO51 7","Total",8272,3958,4314,8128,144,153,656.62,12.6
"2011","SO51 8","SO51 8","Total",4633,2114,2519,4569,64,59,179.06,25.9
"2011","SO51 9","SO51 9","Total",876,434,442,870,6,30,1181.63,0.7
"2011","SO52 9","SO52 9","Total",7037,3416,3621,6987,50,66,810.75,8.7
"2011","SO53 1","SO53 1","Total",5232,2523,2709,5101,131,133,182.83,28.6
"2011","SO53 2","SO53 2","Total",8335,4019,4316,8276,59,78,202.60,41.1
"2011","SO53 3","SO53 3","Total",6437,3090,3347,6423,14,73,206.24,31.2
"2011","SO53 4","SO53 4","Total",7462,3690,3772,7462,0,183,261.94,28.5
"2011","SO53 5","SO53 5","Total",4993,2452,2541,4987,6,121,218.39,22.9
"2011","SP1  1","SP1  1","Total",4949,2343,2606,4732,217,84,510.47,9.7
"2011","SP1  2","SP1  2","Total",3922,1785,2137,3592,330,61,174.72,22.4
"2011","SP1  3","SP1  3","Total",12620,6002,6618,12294,326,313,718.11,17.6
"2011","SP10 1","SP10 1","Total",3889,1849,2040,3853,36,23,209.18,18.6
"2011","SP10 2","SP10 2","Total",9767,4777,4990,9672,95,128,451.04,21.7
"2011","SP10 3","SP10 3","Total",14110,6886,7224,13782,328,174,727.10,19.4
"2011","SP10 4","SP10 4","Total",6845,3392,3453,6823,22,79,326.45,21.0
"2011","SP10 5","SP10 5","Total",6041,2947,3094,6041,0,47,164.57,36.7
"2011","SP11 0","SP11 0","Total",3439,1676,1763,3379,60,136,8747.73,0.4
"2011","SP11 6","SP11 6","Total",4351,2162,2189,4230,121,73,5417.68,0.8
"2011","SP11 7","SP11 7","Total",4452,2155,2297,4350,102,150,6039.34,0.7
"2011","SP11 8","SP11 8","Total",4080,2043,2037,3954,126,140,5747.50,0.7
"2011","SP11 9","SP11 9","Total",7124,3709,3415,6574,550,111,5562.32,1.3
"2011","SP2  0","SP2  0","Total",4922,2360,2562,4790,132,121,3559.39,1.4
"2011","SP2  7","SP2  7","Total",7230,3535,3695,7111,119,64,224.13,32.3
"2011","SP2  8","SP2  8","Total",8325,3953,4372,8188,137,176,1835.71,4.5
"2011","SP2  9","SP2  9","Total",8832,4312,4520,8813,19,92,548.83,16.1
"2011","SP3  4","SP3  4","Total",4241,2082,2159,4154,87,135,13087.74,0.3
"2011","SP3  5","SP3  5","Total",2913,1414,1499,2910,3,94,8382.85,0.3
"2011","SP3  6","SP3  6","Total",4149,1984,2165,4128,21,137,6585.81,0.6
"2011","SP4  0","SP4  0","Total",2616,1283,1333,2613,3,70,4863.41,0.5
"2011","SP4  6","SP4  6","Total",4011,1919,2092,3991,20,108,4164.77,1.0
"2011","SP4  7","SP4  7","Total",10825,5290,5535,10636,189,157,3329.21,3.3
"2011","SP4  8","SP4  8","Total",7993,4283,3710,7272,721,158,4165.19,1.9
"2011","SP4  9","SP4  9","Total",5666,3185,2481,4812,854,110,4244.05,1.3
"2011","SP5  1","SP5  1","Total",4699,2296,2403,4650,49,144,8021.12,0.6
"2011","SP5  2","SP5  2","Total",6223,3013,3210,6090,133,147,6081.68,1.0
"2011","SP5  3","SP5  3","Total",5734,2733,3001,5729,5,133,4346.67,1.3
"2011","SP5  4","SP5  4","Total",2255,1085,1170,2255,0,89,7357.26,0.3
"2011","SP5  5","SP5  5","Total",3450,1699,1751,3344,106,118,13829.86,0.2
"2011","SP6  1","SP6  1","Total",6411,3090,3321,6220,191,114,1010.17,6.3
"2011","SP6  2","SP6  2","Total",2736,1344,1392,2733,3,78,6027.14,0.5
"2011","SP6  3","SP6  3","Total",4900,2429,2471,4887,13,108,8372.68,0.6
"2011","SP7  0","SP7  0","Total",2599,1426,1173,2275,324,72,5149.65,0.5
"2011","SP7  8","SP7  8","Total",7094,3385,3709,6919,175,112,438.03,16.2
"2011","SP7  9","SP7  9","Total",3863,1772,2091,3503,360,148,6930.29,0.6
"2011","SP8  4","SP8  4","Total",11278,5525,5753,11142,136,171,1320.23,8.5
"2011","SP8  5","SP8  5","Total",3292,1606,1686,3288,4,88,6189.97,0.5
"2011","SP9  7","SP9  7","Total",10678,6395,4283,8330,2348,161,2865.13,3.7
"2011","SR1  1","SR1  1","Total",939,564,375,629,310,20,32.13,29.2
"2011","SR1  2","SR1  2","Total",3498,1844,1654,3179,319,16,147.49,23.7
"2011","SR1  3","SR1  3","Total",977,510,467,977,0,6,33.01,29.6
"2011","SR2  0","SR2  0","Total",9680,4614,5066,9580,100,33,524.63,18.5
"2011","SR2  7","SR2  7","Total",8699,4704,3995,8449,250,113,180.32,48.2
"2011","SR2  8","SR2  8","Total",6974,3507,3467,6905,69,36,174.93,39.9
"2011","SR2  9","SR2  9","Total",7580,3700,3880,7539,41,40,258.54,29.3
"2011","SR3  1","SR3  1","Total",12522,5967,6555,12501,21,58,378.98,33.0
"2011","SR3  2","SR3  2","Total",10449,5047,5402,10399,50,66,902.59,11.6
"2011","SR3  3","SR3  3","Total",9449,4438,5011,9375,74,56,349.34,27.0
"2011","SR3  4","SR3  4","Total",6992,3386,3606,6953,39,19,164.55,42.5
"2011","SR4  0","SR4  0","Total",7259,3456,3803,7225,34,23,237.36,30.6
"2011","SR4  6","SR4  6","Total",8461,4128,4333,7863,598,64,269.47,31.4
"2011","SR4  7","SR4  7","Total",10212,4999,5213,9841,371,73,144.02,70.9
"2011","SR4  8","SR4  8","Total",9377,4433,4944,9186,191,41,205.27,45.7
"2011","SR4  9","SR4  9","Total",6271,3003,3268,6261,10,27,698.56,9.0
"2011","SR5  1","SR5  1","Total",6013,2946,3067,5946,67,37,232.83,25.8
"2011","SR5  2","SR5  2","Total",5112,2497,2615,5064,48,12,238.73,21.4
"2011","SR5  3","SR5  3","Total",8465,4067,4398,8361,104,35,304.85,27.8
"2011","SR5  4","SR5  4","Total",6136,2892,3244,6129,7,21,105.09,58.4
"2011","SR5  5","SR5  5","Total",9066,4230,4836,8887,179,28,247.59,36.6
"2011","SR6  0","SR6  0","Total",5742,2946,2796,5648,94,24,111.07,51.7
"2011","SR6  7","SR6  7","Total",9778,4644,5134,9778,0,120,1079.85,9.1
"2011","SR6  8","SR6  8","Total",6144,2929,3215,6119,25,35,157.52,39.0
"2011","SR6  9","SR6  9","Total",8422,4015,4407,8260,162,53,130.17,64.7
"2011","SR7  0","SR7  0","Total",5838,2882,2956,5746,92,35,839.44,7.0
"2011","SR7  7","SR7  7","Total",10129,5021,5108,9970,159,38,595.49,17.0
"2011","SR7  8","SR7  8","Total",7522,3576,3946,7468,54,35,1250.46,6.0
"2011","SR7  9","SR7  9","Total",7676,3758,3918,7585,91,28,765.45,10.0
"2011","SR8  1","SR8  1","Total",4651,2281,2370,4646,5,37,238.99,19.5
"2011","SR8  2","SR8  2","Total",8279,3958,4321,8278,1,48,243.75,34.0
"2011","SR8  3","SR8  3","Total",7573,3753,3820,7488,85,42,1699.86,4.5
"2011","SR8  4","SR8  4","Total",7916,3885,4031,7844,72,38,321.23,24.6
"2011","SR8  5","SR8  5","Total",7025,3376,3649,6842,183,48,296.60,23.7
"2011","SS0  0","SS0  0","Total",9970,4924,5046,9927,43,115,248.36,40.1
"2011","SS0  7","SS0  7","Total",10059,5092,4967,9699,360,68,132.03,76.2
"2011","SS0  8","SS0  8","Total",7844,3970,3874,7309,535,114,132.02,59.4
"2011","SS0  9","SS0  9","Total",13581,6715,6866,13522,59,131,128.03,106.1
"2011","SS1  1","SS1  1","Total",3138,1585,1553,2914,224,44,49.75,63.1
"2011","SS1  2","SS1  2","Total",14061,7032,7029,13891,170,148,185.57,75.8
"2011","SS1  3","SS1  3","Total",8754,4173,4581,8724,30,156,312.32,28.0
"2011","SS11 7","SS11 7","Total",7001,3398,3603,6789,212,42,1365.70,5.1
"2011","SS11 8","SS11 8","Total",9737,4782,4955,9683,54,92,1385.87,7.0
"2011","SS12 0","SS12 0","Total",6959,3367,3592,6909,50,42,605.09,11.5
"2011","SS12 9","SS12 9","Total",11070,5430,5640,11004,66,100,792.37,14.0
"2011","SS13 1","SS13 1","Total",9231,4522,4709,9168,63,58,336.09,27.5
"2011","SS13 2","SS13 2","Total",5396,2639,2757,5327,69,36,831.09,6.5
"2011","SS13 3","SS13 3","Total",7497,3661,3836,7497,0,39,637.60,11.8
"2011","SS14 1","SS14 1","Total",9518,4597,4921,9476,42,57,189.94,50.1
"2011","SS14 2","SS14 2","Total",11007,5067,5940,10694,313,52,561.92,19.6
"2011","SS14 3","SS14 3","Total",4390,2119,2271,4390,0,31,123.21,35.6
"2011","SS15 4","SS15 4","Total",5443,2662,2781,5418,25,56,468.34,11.6
"2011","SS15 5","SS15 5","Total",16186,7712,8474,16085,101,94,302.84,53.4
"2011","SS15 6","SS15 6","Total",8634,4180,4454,8620,14,57,467.66,18.5
"2011","SS16 4","SS16 4","Total",11825,5812,6013,11780,45,71,482.60,24.5
"2011","SS16 5","SS16 5","Total",9879,4841,5038,9853,26,94,559.60,17.7
"2011","SS16 6","SS16 6","Total",7786,3815,3971,7694,92,99,281.46,27.7
"2011","SS17 0","SS17 0","Total",8181,4058,4123,8140,41,94,971.70,8.4
"2011","SS17 7","SS17 7","Total",11475,5461,6014,11423,52,81,254.38,45.1
"2011","SS17 8","SS17 8","Total",9021,4445,4576,9018,3,98,1178.74,7.7
"2011","SS17 9","SS17 9","Total",4146,2039,2107,4141,5,47,2087.90,2.0
"2011","SS2  4","SS2  4","Total",16707,8079,8628,16625,82,139,588.56,28.4
"2011","SS2  5","SS2  5","Total",8417,4177,4240,8365,52,50,227.45,37.0
"2011","SS2  6","SS2  6","Total",11331,5564,5767,11244,87,88,326.67,34.7
"2011","SS3  0","SS3  0","Total",7327,3613,3714,7279,48,90,2416.85,3.0
"2011","SS3  8","SS3  8","Total",5606,2732,2874,5606,0,89,191.83,29.2
"2011","SS3  9","SS3  9","Total",15671,7509,8162,15535,136,138,3396.07,4.6
"2011","SS4  1","SS4  1","Total",11621,5629,5992,11565,56,100,1912.19,6.1
"2011","SS4  2","SS4  2","Total",843,410,433,768,75,11,1633.79,0.5
"2011","SS4  3","SS4  3","Total",8529,4177,4352,8511,18,94,3803.62,2.2
"2011","SS5  4","SS5  4","Total",9369,4641,4728,9369,0,124,886.63,10.6
"2011","SS5  5","SS5  5","Total",5888,2849,3039,5884,4,60,284.31,20.7
"2011","SS5  6","SS5  6","Total",6283,3094,3189,6283,0,64,771.35,8.1
"2011","SS6  7","SS6  7","Total",6613,3181,3432,6593,20,74,370.51,17.8
"2011","SS6  8","SS6  8","Total",12843,6329,6514,12559,284,158,437.17,29.4
"2011","SS6  9","SS6  9","Total",12336,6025,6311,12299,37,93,388.66,31.7
"2011","SS7  1","SS7  1","Total",9343,4589,4754,9146,197,122,570.77,16.4
"2011","SS7  2","SS7  2","Total",9707,4697,5010,9690,17,118,963.39,10.1
"2011","SS7  3","SS7  3","Total",10934,5264,5670,10809,125,126,584.02,18.7
"2011","SS7  4","SS7  4","Total",8696,4244,4452,8696,0,66,164.49,52.9
"2011","SS7  5","SS7  5","Total",10576,5170,5406,10497,79,101,352.56,30.0
"2011","SS8  0","SS8  0","Total",6890,3415,3475,6827,63,41,661.39,10.4
"2011","SS8  7","SS8  7","Total",8132,3998,4134,8067,65,55,197.38,41.2
"2011","SS8  8","SS8  8","Total",7474,3611,3863,7472,2,33,227.35,32.9
"2011","SS8  9","SS8  9","Total",15674,7640,8034,15596,78,89,741.76,21.1
"2011","SS9  1","SS9  1","Total",9711,4676,5035,9510,201,86,120.39,80.7
"2011","SS9  2","SS9  2","Total",8307,4073,4234,8262,45,168,285.63,29.1
"2011","SS9  3","SS9  3","Total",10504,5063,5441,10451,53,144,332.19,31.6
"2011","SS9  4","SS9  4","Total",9703,4659,5044,9665,38,82,224.86,43.2
"2011","SS9  5","SS9  5","Total",11853,5788,6065,11790,63,118,336.94,35.2
"2011","ST1  2","ST1  2","Total",3631,1907,1724,3614,17,13,52.80,68.8
"2011","ST1  3","ST1  3","Total",4998,2722,2276,4779,219,29,209.99,23.8
"2011","ST1  4","ST1  4","Total",4069,2205,1864,3985,84,38,254.26,16.0
"2011","ST1  5","ST1  5","Total",3319,1765,1554,3314,5,34,112.39,29.5
"2011","ST1  6","ST1  6","Total",13843,6859,6984,13841,2,93,359.10,38.5
"2011","ST10 1","ST10 1","Total",11283,5561,5722,11138,145,124,1477.86,7.6
"2011","ST10 2","ST10 2","Total",5191,2602,2589,5095,96,73,6255.14,0.8
"2011","ST10 3","ST10 3","Total",2223,1140,1083,2213,10,30,5028.20,0.4
"2011","ST10 4","ST10 4","Total",6901,3453,3448,6859,42,106,6052.30,1.1
"2011","ST11 9","ST11 9","Total",9995,4939,5056,9875,120,122,3784.76,2.6
"2011","ST12 9","ST12 9","Total",3809,1841,1968,3702,107,39,2224.37,1.7
"2011","ST13 5","ST13 5","Total",6307,3059,3248,6186,121,64,641.38,9.8
"2011","ST13 6","ST13 6","Total",6208,3006,3202,6121,87,62,244.20,25.4
"2011","ST13 7","ST13 7","Total",6781,3388,3393,6700,81,79,7654.93,0.9
"2011","ST13 8","ST13 8","Total",8685,4217,4468,8535,150,114,6363.23,1.4
"2011","ST14 5","ST14 5","Total",4748,2368,2380,4505,243,88,4249.62,1.1
"2011","ST14 7","ST14 7","Total",8383,4124,4259,8314,69,81,483.99,17.3
"2011","ST14 8","ST14 8","Total",7414,4112,3302,6418,996,129,5182.21,1.4
"2011","ST15 0","ST15 0","Total",8964,4424,4540,8816,148,138,4979.60,1.8
"2011","ST15 8","ST15 8","Total",12448,6018,6430,12260,188,190,3281.05,3.8
"2011","ST16 1","ST16 1","Total",12949,6288,6661,12780,169,154,667.70,19.4
"2011","ST16 2","ST16 2","Total",1716,891,825,1700,16,6,128.28,13.4
"2011","ST16 3","ST16 3","Total",16290,9078,7212,15371,919,189,536.76,30.3
"2011","ST17 0","ST17 0","Total",12204,5957,6247,12109,95,235,6305.99,1.9
"2011","ST17 4","ST17 4","Total",12322,6128,6194,12262,60,145,570.59,21.6
"2011","ST17 9","ST17 9","Total",15192,7406,7786,15119,73,150,399.75,38.0
"2011","ST18 0","ST18 0","Total",10721,5570,5151,9764,957,208,10848.40,1.0
"2011","ST18 9","ST18 9","Total",5502,2777,2725,5312,190,84,8698.51,0.6
"2011","ST19 5","ST19 5","Total",8526,4181,4345,8505,21,103,4173.72,2.0
"2011","ST19 9","ST19 9","Total",6225,2996,3229,6178,47,102,5755.94,1.1
"2011","ST2  0","ST2  0","Total",10287,4954,5333,10189,98,31,448.23,23.0
"2011","ST2  7","ST2  7","Total",8011,3927,4084,7986,25,68,312.85,25.6
"2011","ST2  8","ST2  8","Total",7269,3486,3783,7221,48,40,328.48,22.1
"2011","ST2  9","ST2  9","Total",8625,4196,4429,8565,60,36,497.35,17.3
"2011","ST20 0","ST20 0","Total",6711,3323,3388,6698,13,151,8153.65,0.8
"2011","ST21 6","ST21 6","Total",5674,2690,2984,5404,270,121,9772.67,0.6
"2011","ST3  1","ST3  1","Total",5757,2874,2883,5730,27,26,168.31,34.2
"2011","ST3  2","ST3  2","Total",7801,3757,4044,7738,63,45,321.25,24.3
"2011","ST3  3","ST3  3","Total",7937,3915,4022,7931,6,34,214.97,36.9
"2011","ST3  4","ST3  4","Total",9272,4582,4690,9115,157,53,917.16,10.1
"2011","ST3  5","ST3  5","Total",13915,6891,7024,13854,61,62,334.32,41.6
"2011","ST3  6","ST3  6","Total",9687,4773,4914,9585,102,44,309.38,31.3
"2011","ST3  7","ST3  7","Total",13301,6569,6732,13281,20,144,759.91,17.5
"2011","ST4  1","ST4  1","Total",1335,808,527,1307,28,4,81.09,16.5
"2011","ST4  2","ST4  2","Total",7363,4162,3201,6523,840,95,246.65,29.9
"2011","ST4  3","ST4  3","Total",7319,3617,3702,7280,39,29,228.08,32.1
"2011","ST4  4","ST4  4","Total",6533,3228,3305,6533,0,34,205.03,31.9
"2011","ST4  5","ST4  5","Total",7816,3929,3887,7769,47,43,278.50,28.1
"2011","ST4  6","ST4  6","Total",8009,3947,4062,7967,42,60,264.31,30.3
"2011","ST4  7","ST4  7","Total",6742,3421,3321,6711,31,48,208.60,32.3
"2011","ST4  8","ST4  8","Total",12080,5944,6136,11779,301,161,958.28,12.6
"2011","ST5  0","ST5  0","Total",9063,4516,4547,8968,95,83,254.70,35.6
"2011","ST5  1","ST5  1","Total",3084,1576,1508,2994,90,28,72.87,42.3
"2011","ST5  2","ST5  2","Total",9149,4508,4641,9072,77,93,458.84,19.9
"2011","ST5  3","ST5  3","Total",9535,4641,4894,9529,6,166,348.59,27.4
"2011","ST5  4","ST5  4","Total",6179,3002,3177,6174,5,95,2463.65,2.5
"2011","ST5  5","ST5  5","Total",5936,2945,2991,2700,3236,112,2961.66,2.0
"2011","ST5  6","ST5  6","Total",8796,4352,4444,8767,29,66,1557.52,5.6
"2011","ST5  7","ST5  7","Total",11636,5760,5876,11531,105,56,629.29,18.5
"2011","ST5  8","ST5  8","Total",11532,5715,5817,11341,191,86,532.73,21.6
"2011","ST5  9","ST5  9","Total",7490,3692,3798,7422,68,49,226.01,33.1
"2011","ST6  1","ST6  1","Total",7253,3579,3674,7231,22,29,186.64,38.9
"2011","ST6  2","ST6  2","Total",2891,1508,1383,2885,6,12,90.58,31.9
"2011","ST6  3","ST6  3","Total",3415,1716,1699,3271,144,23,149.74,22.8
"2011","ST6  4","ST6  4","Total",4778,2483,2295,4683,95,21,345.82,13.8
"2011","ST6  5","ST6  5","Total",10086,4875,5211,9948,138,46,360.03,28.0
"2011","ST6  6","ST6  6","Total",14103,6840,7263,13971,132,65,419.14,33.6
"2011","ST6  7","ST6  7","Total",9374,4547,4827,9329,45,51,262.78,35.7
"2011","ST6  8","ST6  8","Total",12554,6149,6405,12501,53,87,1294.82,9.7
"2011","ST7  1","ST7  1","Total",11024,5448,5576,10906,118,63,824.18,13.4
"2011","ST7  2","ST7  2","Total",11893,5781,6112,11785,108,217,965.21,12.3
"2011","ST7  3","ST7  3","Total",7451,3701,3750,7375,76,96,2097.13,3.6
"2011","ST7  4","ST7  4","Total",14601,7263,7338,14593,8,123,1031.63,14.2
"2011","ST7  8","ST7  8","Total",7914,3908,4006,7877,37,56,1878.19,4.2
"2011","ST8  6","ST8  6","Total",11226,5446,5780,11156,70,85,878.28,12.8
"2011","ST8  7","ST8  7","Total",9149,4486,4663,9032,117,90,1918.04,4.8
"2011","ST9  0","ST9  0","Total",6155,3028,3127,5995,160,61,2083.40,3.0
"2011","ST9  9","ST9  9","Total",5510,2697,2813,5463,47,102,2731.28,2.0
"2011","SW10 0","SW10 0","Total",9055,4336,4719,9045,10,168,64.32,140.8
"2011","SW10 9","SW10 9","Total",9423,4642,4781,9315,108,181,67.83,138.9
"2011","SW11 1","SW11 1","Total",9502,4656,4846,9478,24,56,107.95,88.0
"2011","SW11 2","SW11 2","Total",13912,6612,7300,13880,32,97,98.29,141.5
"2011","SW11 3","SW11 3","Total",11688,5786,5902,11620,68,121,75.31,155.2
"2011","SW11 4","SW11 4","Total",8147,3990,4157,7981,166,150,107.14,76.0
"2011","SW11 5","SW11 5","Total",17165,8247,8918,17165,0,176,116.20,147.7
"2011","SW11 6","SW11 6","Total",11303,5571,5732,11265,38,262,95.64,118.2
"2011","SW12 0","SW12 0","Total",7826,3713,4113,7813,13,76,72.82,107.5
"2011","SW12 8","SW12 8","Total",12832,6218,6614,12618,214,317,119.77,107.1
"2011","SW12 9","SW12 9","Total",10928,5331,5597,10872,56,84,109.66,99.7
"2011","SW13 0","SW13 0","Total",6917,3304,3613,6873,44,165,133.62,51.8
"2011","SW13 8","SW13 8","Total",1917,952,965,1917,0,52,43.67,43.9
"2011","SW13 9","SW13 9","Total",7356,3540,3816,7305,51,216,212.50,34.6
"2011","SW14 7","SW14 7","Total",7593,3681,3912,7587,6,178,150.89,50.3
"2011","SW14 8","SW14 8","Total",9237,4434,4803,9087,150,212,507.62,18.2
"2011","SW15 1","SW15 1","Total",10044,4779,5265,10034,10,229,108.35,92.7
"2011","SW15 2","SW15 2","Total",10338,4882,5456,10260,78,118,102.34,101.0
"2011","SW15 3","SW15 3","Total",11536,5492,6044,11211,325,181,268.45,43.0
"2011","SW15 4","SW15 4","Total",10338,4749,5589,9747,591,100,199.23,51.9
"2011","SW15 5","SW15 5","Total",9901,4478,5423,8864,1037,220,206.93,47.8
"2011","SW15 6","SW15 6","Total",8299,4030,4269,8278,21,225,98.04,84.6
"2011","SW16 1","SW16 1","Total",10750,5291,5459,10565,185,112,125.18,85.9
"2011","SW16 2","SW16 2","Total",16493,8041,8452,16155,338,162,167.29,98.6
"2011","SW16 3","SW16 3","Total",8864,4442,4422,8758,106,168,198.42,44.7
"2011","SW16 4","SW16 4","Total",13469,6521,6948,13369,100,211,158.06,85.2
"2011","SW16 5","SW16 5","Total",17193,8444,8749,17091,102,186,169.47,101.5
"2011","SW16 6","SW16 6","Total",14158,6929,7229,13847,311,185,116.18,121.9
"2011","SW17 0","SW17 0","Total",14832,7067,7765,14390,442,128,188.51,78.7
"2011","SW17 6","SW17 6","Total",1806,917,889,1786,20,9,43.77,41.3
"2011","SW17 7","SW17 7","Total",12324,6058,6266,12027,297,202,119.74,102.9
"2011","SW17 8","SW17 8","Total",19501,9309,10192,19408,93,263,146.73,132.9
"2011","SW17 9","SW17 9","Total",15752,7813,7939,15693,59,135,120.95,130.2
"2011","SW18 1","SW18 1","Total",10734,5488,5246,10715,19,144,136.18,78.8
"2011","SW18 2","SW18 2","Total",9817,4769,5048,9778,39,174,107.34,91.5
"2011","SW18 3","SW18 3","Total",14557,7618,6939,13310,1247,286,196.71,74.0
"2011","SW18 4","SW18 4","Total",10453,5033,5420,10427,26,48,102.48,102.0
"2011","SW18 5","SW18 5","Total",13431,6486,6945,13431,0,209,131.79,101.9
"2011","SW19 1","SW19 1","Total",10393,5188,5205,10294,99,58,95.12,109.3
"2011","SW19 2","SW19 2","Total",12147,6112,6035,11916,231,82,147.58,82.3
"2011","SW19 3","SW19 3","Total",10792,5384,5408,10792,0,201,209.55,51.5
"2011","SW19 4","SW19 4","Total",6463,3180,3283,6345,118,191,426.39,15.2
"2011","SW19 5","SW19 5","Total",3987,1935,2052,3898,89,171,140.68,28.3
"2011","SW19 6","SW19 6","Total",12029,5671,6358,11875,154,126,119.12,101.0
"2011","SW19 7","SW19 7","Total",6379,3158,3221,6352,27,227,144.83,44.0
"2011","SW19 8","SW19 8","Total",15486,7595,7891,15304,182,202,237.54,65.2
"2011","SW1A 1","SW1A 1","Total",246,150,96,245,1,3,20.93,11.8
"2011","SW1E 5","SW1E 5","Total",258,132,126,191,67,2,5.74,44.9
"2011","SW1E 6","SW1E 6","Total",661,437,224,398,263,17,30.29,21.8
"2011","SW1H 0","SW1H 0","Total",388,211,177,388,0,7,19.15,20.3
"2011","SW1H 9","SW1H 9","Total",346,197,149,346,0,7,15.05,23.0
"2011","SW1P 1","SW1P 1","Total",2590,1354,1236,2341,249,55,18.95,136.7
"2011","SW1P 2","SW1P 2","Total",3526,1859,1667,3338,188,43,19.53,180.5
"2011","SW1P 3","SW1P 3","Total",855,537,318,649,206,39,37.56,22.8
"2011","SW1P 4","SW1P 4","Total",6537,3302,3235,6481,56,75,37.26,175.4
"2011","SW1V 1","SW1V 1","Total",2144,1077,1067,2032,112,28,18.25,117.5
"2011","SW1V 2","SW1V 2","Total",5743,2876,2867,5731,12,82,23.50,244.4
"2011","SW1V 3","SW1V 3","Total",8580,4183,4397,8535,45,99,36.61,234.4
"2011","SW1V 4","SW1V 4","Total",6107,3045,3062,6106,1,101,23.08,264.6
"2011","SW1W 0","SW1W 0","Total",695,373,322,611,84,16,31.06,22.4
"2011","SW1W 8","SW1W 8","Total",5565,2763,2802,5561,4,133,39.82,139.8
"2011","SW1W 9","SW1W 9","Total",2297,1140,1157,2297,0,129,29.08,79.0
"2011","SW1X 0","SW1X 0","Total",1894,984,910,1894,0,43,14.82,127.8
"2011","SW1X 7","SW1X 7","Total",998,505,493,998,0,40,32.38,30.8
"2011","SW1X 8","SW1X 8","Total",1447,735,712,1447,0,31,20.10,72.0
"2011","SW1X 9","SW1X 9","Total",1687,898,789,1687,0,31,19.13,88.2
"2011","SW1Y 4","SW1Y 4","Total",299,177,122,299,0,2,25.02,12.0
"2011","SW1Y 6","SW1Y 6","Total",251,148,103,243,8,3,11.55,21.7
"2011","SW2  1","SW2  1","Total",7312,3565,3747,7280,32,55,50.13,145.9
"2011","SW2  2","SW2  2","Total",12003,5970,6033,11933,70,104,76.21,157.5
"2011","SW2  3","SW2  3","Total",13760,6699,7061,13633,127,141,112.65,122.1
"2011","SW2  4","SW2  4","Total",11238,5466,5772,11212,26,118,81.36,138.1
"2011","SW2  5","SW2  5","Total",10018,5151,4867,9569,449,63,67.20,149.1
"2011","SW20 0","SW20 0","Total",9083,4413,4670,9039,44,227,242.84,37.4
"2011","SW20 8","SW20 8","Total",10556,5113,5443,10416,140,161,125.21,84.3
"2011","SW20 9","SW20 9","Total",8636,4243,4393,8554,82,166,218.15,39.6
"2011","SW3  1","SW3  1","Total",1100,577,523,1100,0,18,11.66,94.3
"2011","SW3  2","SW3  2","Total",4485,2194,2291,4485,0,112,34.17,131.3
"2011","SW3  3","SW3  3","Total",4352,2050,2302,4352,0,85,18.10,240.4
"2011","SW3  4","SW3  4","Total",4203,2127,2076,3909,294,153,57.06,73.7
"2011","SW3  5","SW3  5","Total",4989,2437,2552,4956,33,140,34.31,145.4
"2011","SW3  6","SW3  6","Total",3041,1433,1608,2850,191,95,34.38,88.5
"2011","SW4  0","SW4  0","Total",6382,3245,3137,6356,26,85,61.14,104.4
"2011","SW4  6","SW4  6","Total",10356,5196,5160,10301,55,100,78.41,132.1
"2011","SW4  7","SW4  7","Total",8423,4180,4243,8304,119,54,47.10,178.8
"2011","SW4  8","SW4  8","Total",7320,3586,3734,7320,0,95,64.83,112.9
"2011","SW4  9","SW4  9","Total",7105,3584,3521,7079,26,131,89.09,79.8
"2011","SW5  0","SW5  0","Total",7010,3645,3365,6917,93,96,37.44,187.2
"2011","SW5  9","SW5  9","Total",8483,4434,4049,8359,124,104,42.26,200.7
"2011","SW6  1","SW6  1","Total",7004,3447,3557,6959,45,87,58.16,120.4
"2011","SW6  2","SW6  2","Total",12535,6024,6511,12220,315,201,82.34,152.2
"2011","SW6  3","SW6  3","Total",8994,4332,4662,8994,0,282,134.11,67.1
"2011","SW6  4","SW6  4","Total",7300,3442,3858,7269,31,111,52.59,138.8
"2011","SW6  5","SW6  5","Total",7657,3649,4008,7636,21,103,40.44,189.3
"2011","SW6  6","SW6  6","Total",11475,5470,6005,11475,0,236,88.80,129.2
"2011","SW6  7","SW6  7","Total",10184,4930,5254,10168,16,59,50.70,200.9
"2011","SW7  1","SW7  1","Total",3739,2126,1613,2596,1143,64,216.61,17.3
"2011","SW7  2","SW7  2","Total",2283,1181,1102,2020,263,75,98.06,23.3
"2011","SW7  3","SW7  3","Total",4444,2279,2165,3835,609,78,27.93,159.1
"2011","SW7  4","SW7  4","Total",4328,2340,1988,4269,59,54,19.97,216.7
"2011","SW7  5","SW7  5","Total",5058,2602,2456,5019,39,120,33.60,150.5
"2011","SW8  1","SW8  1","Total",11047,5827,5220,10871,176,115,75.52,146.3
"2011","SW8  2","SW8  2","Total",10224,5276,4948,10219,5,119,49.13,208.1
"2011","SW8  3","SW8  3","Total",6226,2943,3283,6226,0,44,66.95,93.0
"2011","SW8  4","SW8  4","Total",8539,4280,4259,8534,5,80,111.53,76.6
"2011","SW8  5","SW8  5","Total",372,211,161,372,0,5,52.36,7.1
"2011","SW9  0","SW9  0","Total",11392,5984,5408,11304,88,122,74.50,152.9
"2011","SW9  6","SW9  6","Total",5951,2892,3059,5936,15,70,41.26,144.2
"2011","SW9  7","SW9  7","Total",8890,4332,4558,8886,4,87,64.89,137.0
"2011","SW9  8","SW9  8","Total",5556,2813,2743,5547,9,62,47.98,115.8
"2011","SW9  9","SW9  9","Total",11610,5944,5666,11527,83,72,62.13,186.9
"2011","SY1  1","SY1  1","Total",1532,807,725,1490,42,29,65.60,23.4
"2011","SY1  2","SY1  2","Total",7160,3735,3425,6723,437,61,201.14,35.6
"2011","SY1  3","SY1  3","Total",8429,4131,4298,8360,69,59,939.05,9.0
"2011","SY1  4","SY1  4","Total",9415,4637,4778,9408,7,59,458.79,20.5
"2011","SY10 0","SY10 0","Total",2231,1147,1084,2212,19,39,23748.83,0.1
"2011","SY10 7","SY10 7","Total",4078,1941,2137,3830,248,63,8254.84,0.5
"2011","SY10 8","SY10 8","Total",3527,1757,1770,3525,2,50,6804.04,0.5
"2011","SY10 9","SY10 9","Total",4827,2389,2438,4752,75,85,6438.24,0.7
"2011","SY11 1","SY11 1","Total",6031,2969,3062,5997,34,65,384.87,15.7
"2011","SY11 2","SY11 2","Total",10751,5156,5595,10504,247,121,456.93,23.5
"2011","SY11 3","SY11 3","Total",5779,2831,2948,5411,368,62,1768.18,3.3
"2011","SY11 4","SY11 4","Total",4453,2192,2261,4404,49,65,6302.98,0.7
"2011","SY12 0","SY12 0","Total",4437,2187,2250,4401,36,73,5215.38,0.9
"2011","SY12 9","SY12 9","Total",3813,1909,1904,3560,253,80,7625.68,0.5
"2011","SY13 1","SY13 1","Total",9710,4783,4927,9557,153,102,1880.68,5.2
"2011","SY13 2","SY13 2","Total",4062,2020,2042,4029,33,78,5726.36,0.7
"2011","SY13 3","SY13 3","Total",3027,1502,1525,2988,39,51,7147.98,0.4
"2011","SY13 4","SY13 4","Total",2750,1395,1355,2747,3,50,9726.81,0.3
"2011","SY14 7","SY14 7","Total",2424,1190,1234,2422,2,65,6115.77,0.4
"2011","SY14 8","SY14 8","Total",3220,1570,1650,3162,58,74,5028.68,0.6
"2011","SY15 6","SY15 6","Total",5199,2571,2628,5145,54,91,14214.88,0.4
"2011","SY16 1","SY16 1","Total",6685,3229,3456,6575,110,64,637.90,10.5
"2011","SY16 2","SY16 2","Total",4253,2119,2134,4232,21,58,1144.20,3.7
"2011","SY16 3","SY16 3","Total",2743,1422,1321,2733,10,48,12112.08,0.2
"2011","SY16 4","SY16 4","Total",2551,1288,1263,2547,4,45,11424.79,0.2
"2011","SY17 5","SY17 5","Total",3553,1788,1765,3544,9,59,15013.30,0.2
"2011","SY18 6","SY18 6","Total",4648,2339,2309,4598,50,74,23581.69,0.2
"2011","SY19 7","SY19 7","Total",1169,601,568,1161,8,18,17712.22,0.1
"2011","SY2  5","SY2  5","Total",11879,5779,6100,11728,151,156,477.16,24.9
"2011","SY2  6","SY2  6","Total",5656,2784,2872,5578,78,93,392.19,14.4
"2011","SY20 8","SY20 8","Total",4577,2246,2331,4527,50,70,22083.87,0.2
"2011","SY20 9","SY20 9","Total",2344,1155,1189,2331,13,36,27783.47,0.1
"2011","SY21 0","SY21 0","Total",2821,1412,1409,2818,3,50,21579.27,0.1
"2011","SY21 7","SY21 7","Total",5948,2907,3041,5751,197,74,699.47,8.5
"2011","SY21 8","SY21 8","Total",4695,2341,2354,4669,26,80,14479.32,0.3
"2011","SY21 9","SY21 9","Total",2786,1378,1408,2775,11,46,7390.88,0.4
"2011","SY22 5","SY22 5","Total",1999,1042,957,1968,31,39,9544.14,0.2
"2011","SY22 6","SY22 6","Total",7535,3703,3832,7475,60,112,17366.08,0.4
"2011","SY23 1","SY23 1","Total",7301,3798,3503,7111,190,69,300.12,24.3
"2011","SY23 2","SY23 2","Total",3967,2039,1928,3199,768,52,183.40,21.6
"2011","SY23 3","SY23 3","Total",11362,5697,5665,8757,2605,229,17200.81,0.7
"2011","SY23 4","SY23 4","Total",5401,2687,2714,5329,72,100,24386.31,0.2
"2011","SY23 5","SY23 5","Total",2827,1398,1429,2793,34,42,7070.00,0.4
"2011","SY24 5","SY24 5","Total",4663,2285,2378,4628,35,79,9459.02,0.5
"2011","SY25 6","SY25 6","Total",4343,2122,2221,4328,15,80,43434.09,0.1
"2011","SY3  0","SY3  0","Total",5079,2488,2591,5020,59,100,864.03,5.9
"2011","SY3  5","SY3  5","Total",4352,2129,2223,4232,120,63,226.80,19.2
"2011","SY3  6","SY3  6","Total",2672,1265,1407,2635,37,67,189.12,14.1
"2011","SY3  7","SY3  7","Total",7834,3990,3844,7201,633,179,278.13,28.2
"2011","SY3  8","SY3  8","Total",8820,4236,4584,8576,244,247,2209.46,4.0
"2011","SY3  9","SY3  9","Total",5028,2442,2586,4947,81,95,217.62,23.1
"2011","SY4  1","SY4  1","Total",3120,1574,1546,2986,134,73,6252.31,0.5
"2011","SY4  2","SY4  2","Total",2806,1357,1449,2533,273,76,3752.72,0.7
"2011","SY4  3","SY4  3","Total",3967,1966,2001,3946,21,59,6286.42,0.6
"2011","SY4  4","SY4  4","Total",5870,3024,2846,5542,328,120,9995.70,0.6
"2011","SY4  5","SY4  5","Total",8777,4261,4516,8601,176,153,10338.54,0.8
"2011","SY5  0","SY5  0","Total",6433,3195,3238,6365,68,113,12412.84,0.5
"2011","SY5  6","SY5  6","Total",3890,1937,1953,3887,3,85,12139.44,0.3
"2011","SY5  7","SY5  7","Total",3172,1543,1629,2789,383,72,6759.49,0.5
"2011","SY5  8","SY5  8","Total",3128,1582,1546,3072,56,90,4791.20,0.7
"2011","SY5  9","SY5  9","Total",4665,2338,2327,4623,42,78,11845.94,0.4
"2011","SY6  6","SY6  6","Total",4113,1983,2130,4044,69,62,6696.40,0.6
"2011","SY6  7","SY6  7","Total",2441,1162,1279,2367,74,60,5213.31,0.5
"2011","SY7  0","SY7  0","Total",3547,1793,1754,3454,93,97,16383.96,0.2
"2011","SY7  8","SY7  8","Total",3623,1787,1836,3621,2,88,17735.49,0.2
"2011","SY7  9","SY7  9","Total",4714,2389,2325,4672,42,86,12873.26,0.4
"2011","SY8  1","SY8  1","Total",8438,4044,4394,8297,141,108,391.47,21.6
"2011","SY8  2","SY8  2","Total",3414,1694,1720,3407,7,57,10416.74,0.3
"2011","SY8  3","SY8  3","Total",3423,1693,1730,3415,8,57,7087.30,0.5
"2011","SY8  4","SY8  4","Total",3358,1664,1694,3316,42,90,6909.95,0.5
"2011","SY9  5","SY9  5","Total",2895,1417,1478,2769,126,44,10838.40,0.3
"2011","TA1  1","TA1  1","Total",5752,2785,2967,5679,73,66,159.55,36.1
"2011","TA1  2","TA1  2","Total",12921,6112,6809,12774,147,116,322.76,40.0
"2011","TA1  3","TA1  3","Total",8033,3902,4131,7486,547,140,340.61,23.6
"2011","TA1  4","TA1  4","Total",6096,2904,3192,5838,258,119,173.34,35.2
"2011","TA1  5","TA1  5","Total",6671,3128,3543,6435,236,111,656.55,10.2
"2011","TA10 0","TA10 0","Total",3950,1933,2017,3927,23,85,5415.11,0.7
"2011","TA10 9","TA10 9","Total",5320,2562,2758,5192,128,94,5332.65,1.0
"2011","TA11 6","TA11 6","Total",6430,3122,3308,6380,50,132,3045.71,2.1
"2011","TA11 7","TA11 7","Total",2736,1279,1457,2690,46,67,6291.79,0.4
"2011","TA12 6","TA12 6","Total",6353,3079,3274,6306,47,95,3515.96,1.8
"2011","TA13 5","TA13 5","Total",3973,1897,2076,3940,33,69,1950.82,2.0
"2011","TA14 6","TA14 6","Total",2986,1459,1527,2986,0,49,1157.87,2.6
"2011","TA15 6","TA15 6","Total",831,413,418,829,2,11,593.46,1.4
"2011","TA16 5","TA16 5","Total",1979,964,1015,1950,29,21,1096.56,1.8
"2011","TA17 8","TA17 8","Total",442,207,235,442,0,6,859.97,0.5
"2011","TA18 7","TA18 7","Total",3838,1851,1987,3822,16,76,2106.12,1.8
"2011","TA18 8","TA18 8","Total",6201,2994,3207,6158,43,61,2812.39,2.2
"2011","TA19 0","TA19 0","Total",5772,2752,3020,5740,32,71,3672.51,1.6
"2011","TA19 9","TA19 9","Total",5916,2861,3055,5834,82,87,4473.24,1.3
"2011","TA2  6","TA2  6","Total",8551,4478,4073,7579,972,141,714.13,12.0
"2011","TA2  7","TA2  7","Total",10017,4775,5242,9884,133,87,226.83,44.2
"2011","TA2  8","TA2  8","Total",7956,3842,4114,7875,81,152,3980.78,2.0
"2011","TA20 1","TA20 1","Total",7780,3852,3928,7708,72,73,467.46,16.6
"2011","TA20 2","TA20 2","Total",7552,3712,3840,7483,69,67,1563.75,4.8
"2011","TA20 3","TA20 3","Total",2690,1326,1364,2685,5,43,6483.99,0.4
"2011","TA20 4","TA20 4","Total",2310,1143,1167,2306,4,50,5339.07,0.4
"2011","TA21 0","TA21 0","Total",4092,2035,2057,4036,56,84,6784.80,0.6
"2011","TA21 8","TA21 8","Total",7262,3493,3769,6992,270,91,356.80,20.4
"2011","TA21 9","TA21 9","Total",6801,3246,3555,6632,169,109,3227.83,2.1
"2011","TA22 9","TA22 9","Total",2619,1257,1362,2600,19,39,11216.47,0.2
"2011","TA23 0","TA23 0","Total",5681,2765,2916,5656,25,74,6068.17,0.9
"2011","TA24 5","TA24 5","Total",6406,3048,3358,5352,1054,53,364.84,17.6
"2011","TA24 6","TA24 6","Total",5373,2508,2865,5322,51,46,4485.59,1.2
"2011","TA24 7","TA24 7","Total",1846,892,954,1801,45,27,20880.61,0.1
"2011","TA24 8","TA24 8","Total",5025,2334,2691,4916,109,54,10844.20,0.5
"2011","TA3  5","TA3  5","Total",5773,2777,2996,5691,82,75,6557.79,0.9
"2011","TA3  6","TA3  6","Total",4606,2254,2352,4563,43,90,7177.31,0.6
"2011","TA3  7","TA3  7","Total",4033,1963,2070,3948,85,140,5732.76,0.7
"2011","TA4  1","TA4  1","Total",5280,2581,2699,5241,39,112,3227.64,1.6
"2011","TA4  2","TA4  2","Total",4234,2070,2164,4152,82,86,11709.65,0.4
"2011","TA4  3","TA4  3","Total",5375,2574,2801,5309,66,96,8147.16,0.7
"2011","TA4  4","TA4  4","Total",3960,1890,2070,3882,78,90,3619.10,1.1
"2011","TA5  1","TA5  1","Total",5260,2542,2718,5249,11,98,10877.22,0.5
"2011","TA5  2","TA5  2","Total",4895,2456,2439,4729,166,76,7448.70,0.7
"2011","TA6  3","TA6  3","Total",9569,4775,4794,9464,105,58,189.77,50.4
"2011","TA6  4","TA6  4","Total",12650,6242,6408,12589,61,79,1743.87,7.3
"2011","TA6  5","TA6  5","Total",5934,2969,2965,5892,42,42,241.15,24.6
"2011","TA6  6","TA6  6","Total",11145,5449,5696,11059,86,109,1602.12,7.0
"2011","TA6  7","TA6  7","Total",7022,3380,3642,6861,161,99,718.55,9.8
"2011","TA7  0","TA7  0","Total",4917,2428,2489,4911,6,83,6247.25,0.8
"2011","TA7  8","TA7  8","Total",5948,2869,3079,5935,13,74,4868.19,1.2
"2011","TA7  9","TA7  9","Total",4117,2030,2087,4012,105,96,5619.18,0.7
"2011","TA8  1","TA8  1","Total",7558,3586,3972,7428,130,68,283.26,26.7
"2011","TA8  2","TA8  2","Total",9380,4491,4889,9062,318,66,1853.50,5.1
"2011","TA9  3","TA9  3","Total",8188,4046,4142,8145,43,62,2632.37,3.1
"2011","TA9  4","TA9  4","Total",4192,2060,2132,4066,126,80,4358.88,1.0
"2011","TD12 4","TD12 4","Total",1163,584,579,1148,15,37,11544.99,0.1
"2011","TD15 1","TD15 1","Total",5448,2627,2821,5286,162,79,2181.57,2.5
"2011","TD15 2","TD15 2","Total",11713,5635,6078,11507,206,133,25708.89,0.5
"2011","TF1  1","TF1  1","Total",4312,2183,2129,4190,122,37,133.13,32.4
"2011","TF1  2","TF1  2","Total",7106,3441,3665,7071,35,73,257.24,27.6
"2011","TF1  3","TF1  3","Total",7596,3753,3843,7479,117,104,277.72,27.4
"2011","TF1  5","TF1  5","Total",8583,4285,4298,8565,18,49,356.82,24.1
"2011","TF1  6","TF1  6","Total",9547,4658,4889,9527,20,114,522.94,18.3
"2011","TF10 7","TF10 7","Total",10514,5220,5294,10356,158,159,348.64,30.2
"2011","TF10 8","TF10 8","Total",4503,2284,2219,3757,746,136,6260.85,0.7
"2011","TF10 9","TF10 9","Total",3381,1683,1698,3261,120,69,4468.37,0.8
"2011","TF11 8","TF11 8","Total",6357,3155,3202,6310,47,88,7950.24,0.8
"2011","TF11 9","TF11 9","Total",3550,1785,1765,3539,11,82,6055.51,0.6
"2011","TF12 5","TF12 5","Total",5609,2756,2853,5583,26,71,3272.34,1.7
"2011","TF13 6","TF13 6","Total",3696,1764,1932,3631,65,71,7543.22,0.5
"2011","TF2  0","TF2  0","Total",2639,1325,1314,2639,0,12,134.16,19.7
"2011","TF2  6","TF2  6","Total",6938,3399,3539,6872,66,43,362.99,19.1
"2011","TF2  7","TF2  7","Total",7869,3829,4040,7841,28,56,882.55,8.9
"2011","TF2  8","TF2  8","Total",10334,5131,5203,10209,125,106,1227.84,8.4
"2011","TF2  9","TF2  9","Total",11033,5479,5554,10921,112,170,530.04,20.8
"2011","TF3  1","TF3  1","Total",10859,5362,5497,10839,20,97,345.87,31.4
"2011","TF3  2","TF3  2","Total",9044,4593,4451,9038,6,62,602.41,15.0
"2011","TF3  5","TF3  5","Total",4051,2038,2013,4049,2,42,282.89,14.3
"2011","TF4  2","TF4  2","Total",9126,4539,4587,9081,45,75,566.64,16.1
"2011","TF4  3","TF4  3","Total",9072,4483,4589,8948,124,67,534.50,17.0
"2011","TF5  0","TF5  0","Total",5346,2684,2662,5342,4,74,336.09,15.9
"2011","TF6  5","TF6  5","Total",1435,726,709,1407,28,29,3686.90,0.4
"2011","TF6  6","TF6  6","Total",3562,1775,1787,3430,132,64,7963.13,0.4
"2011","TF7  4","TF7  4","Total",5915,2914,3001,5912,3,50,486.73,12.2
"2011","TF7  5","TF7  5","Total",11716,5669,6047,11618,98,77,397.36,29.5
"2011","TF8  7","TF8  7","Total",2903,1483,1420,2829,74,59,1396.12,2.1
"2011","TF9  1","TF9  1","Total",6282,3099,3183,6255,27,58,280.31,22.4
"2011","TF9  2","TF9  2","Total",6121,3298,2823,5629,492,117,10201.66,0.6
"2011","TF9  3","TF9  3","Total",8252,4170,4082,7826,426,85,7447.74,1.1
"2011","TF9  4","TF9  4","Total",4810,2389,2421,4745,65,101,5903.28,0.8
"2011","TN1  1","TN1  1","Total",3831,2007,1824,3810,21,65,65.01,58.9
"2011","TN1  2","TN1  2","Total",7416,3789,3627,7339,77,95,84.95,87.3
"2011","TN10 3","TN10 3","Total",7971,3798,4173,7918,53,102,239.34,33.3
"2011","TN10 4","TN10 4","Total",8312,3965,4347,8304,8,154,508.00,16.4
"2011","TN11 0","TN11 0","Total",4404,2151,2253,4289,115,128,3160.10,1.4
"2011","TN11 8","TN11 8","Total",3689,1801,1888,3687,2,144,4413.20,0.8
"2011","TN11 9","TN11 9","Total",5779,2862,2917,5709,70,138,3018.49,1.9
"2011","TN12 0","TN12 0","Total",5947,2910,3037,5805,142,105,2385.47,2.5
"2011","TN12 5","TN12 5","Total",3306,1654,1652,3286,20,54,1288.64,2.6
"2011","TN12 6","TN12 6","Total",10404,5127,5277,10354,50,143,2049.54,5.1
"2011","TN12 7","TN12 7","Total",2863,1438,1425,2862,1,88,2189.37,1.3
"2011","TN12 8","TN12 8","Total",2435,1187,1248,2435,0,66,2007.67,1.2
"2011","TN12 9","TN12 9","Total",4520,2240,2280,4518,2,95,4020.70,1.1
"2011","TN13 1","TN13 1","Total",5429,2617,2812,4952,477,182,352.18,15.4
"2011","TN13 2","TN13 2","Total",9270,4531,4739,9109,161,239,949.76,9.8
"2011","TN13 3","TN13 3","Total",10294,4998,5296,10180,114,236,773.92,13.3
"2011","TN14 5","TN14 5","Total",6698,3282,3416,6665,33,103,1031.16,6.5
"2011","TN14 6","TN14 6","Total",3324,1622,1702,3324,0,101,3879.66,0.9
"2011","TN14 7","TN14 7","Total",4948,2438,2510,4948,0,97,2655.52,1.9
"2011","TN15 0","TN15 0","Total",4231,2086,2145,4172,59,162,3104.82,1.4
"2011","TN15 6","TN15 6","Total",9660,4682,4978,9577,83,131,3554.71,2.7
"2011","TN15 7","TN15 7","Total",3440,1681,1759,3382,58,58,3440.27,1.0
"2011","TN15 8","TN15 8","Total",5065,2461,2604,5025,40,87,804.84,6.3
"2011","TN15 9","TN15 9","Total",1942,967,975,1936,6,66,774.16,2.5
"2011","TN16 1","TN16 1","Total",5023,2448,2575,5007,16,111,2386.52,2.1
"2011","TN16 2","TN16 2","Total",2509,1249,1260,2462,47,54,2358.25,1.1
"2011","TN16 3","TN16 3","Total",11761,5768,5993,11754,7,164,1189.04,9.9
"2011","TN17 1","TN17 1","Total",2552,1329,1223,2328,224,71,2216.71,1.2
"2011","TN17 2","TN17 2","Total",3581,1762,1819,3494,87,130,5622.85,0.6
"2011","TN17 3","TN17 3","Total",4799,2309,2490,4519,280,141,1668.76,2.9
"2011","TN17 4","TN17 4","Total",3788,1622,2166,3274,514,147,5038.33,0.8
"2011","TN18 4","TN18 4","Total",3963,1936,2027,3928,35,90,1686.35,2.4
"2011","TN18 5","TN18 5","Total",2649,1332,1317,2621,28,85,3159.06,0.8
"2011","TN19 7","TN19 7","Total",5000,2477,2523,4880,120,108,5387.09,0.9
"2011","TN2  3","TN2  3","Total",9910,4744,5166,9830,80,141,348.32,28.5
"2011","TN2  4","TN2  4","Total",8619,4227,4392,8255,364,182,2220.19,3.9
"2011","TN2  5","TN2  5","Total",9899,4811,5088,9743,156,235,330.07,30.0
"2011","TN20 6","TN20 6","Total",3718,1798,1920,3620,98,117,4715.93,0.8
"2011","TN21 0","TN21 0","Total",5862,2791,3071,5693,169,104,2545.30,2.3
"2011","TN21 8","TN21 8","Total",7152,3452,3700,7090,62,123,1534.79,4.7
"2011","TN21 9","TN21 9","Total",2969,1494,1475,2943,26,72,5007.48,0.6
"2011","TN22 1","TN22 1","Total",6310,3007,3303,6285,25,73,270.32,23.3
"2011","TN22 2","TN22 2","Total",3391,1639,1752,3384,7,70,563.10,6.0
"2011","TN22 3","TN22 3","Total",4230,2102,2128,4046,184,125,4928.22,0.9
"2011","TN22 4","TN22 4","Total",3480,1718,1762,3395,85,85,3728.91,0.9
"2011","TN22 5","TN22 5","Total",8772,4260,4512,8710,62,188,4122.16,2.1
"2011","TN23 1","TN23 1","Total",1721,866,855,1719,2,20,109.41,15.7
"2011","TN23 3","TN23 3","Total",13916,6798,7118,13811,105,163,1784.62,7.8
"2011","TN23 4","TN23 4","Total",5160,2563,2597,5154,6,44,173.74,29.7
"2011","TN23 5","TN23 5","Total",14538,7020,7518,14472,66,106,346.45,42.0
"2011","TN23 6","TN23 6","Total",1529,777,752,1529,0,7,133.71,11.4
"2011","TN23 7","TN23 7","Total",3032,1537,1495,3032,0,23,59.06,51.3
"2011","TN24 0","TN24 0","Total",14213,6886,7327,14099,114,129,653.05,21.8
"2011","TN24 8","TN24 8","Total",6051,2933,3118,5816,235,55,231.52,26.1
"2011","TN24 9","TN24 9","Total",11355,5473,5882,11303,52,127,666.18,17.0
"2011","TN25 4","TN25 4","Total",4842,2371,2471,4842,0,73,4072.83,1.2
"2011","TN25 5","TN25 5","Total",3585,1754,1831,3558,27,73,5844.83,0.6
"2011","TN25 6","TN25 6","Total",4976,2387,2589,4900,76,81,3916.63,1.3
"2011","TN25 7","TN25 7","Total",2153,1053,1100,2134,19,36,3816.35,0.6
"2011","TN26 1","TN26 1","Total",2730,1312,1418,2703,27,38,2362.91,1.2
"2011","TN26 2","TN26 2","Total",3484,1669,1815,3444,40,58,5241.65,0.7
"2011","TN26 3","TN26 3","Total",4968,2454,2514,4898,70,88,6922.85,0.7
"2011","TN27 0","TN27 0","Total",4069,1958,2111,4029,40,68,4352.90,0.9
"2011","TN27 8","TN27 8","Total",3875,1913,1962,3871,4,103,5091.67,0.8
"2011","TN27 9","TN27 9","Total",4460,2133,2327,4448,12,66,3362.97,1.3
"2011","TN28 8","TN28 8","Total",8455,4151,4304,8236,219,74,722.69,11.7
"2011","TN29 0","TN29 0","Total",7442,3621,3821,7327,115,56,7206.25,1.0
"2011","TN29 9","TN29 9","Total",6315,3181,3134,6239,76,53,10357.45,0.6
"2011","TN3  0","TN3  0","Total",5602,2700,2902,5512,90,175,1358.09,4.1
"2011","TN3  8","TN3  8","Total",1706,872,834,1706,0,49,2166.09,0.8
"2011","TN3  9","TN3  9","Total",4414,2141,2273,4362,52,137,7130.34,0.6
"2011","TN30 6","TN30 6","Total",5626,2582,3044,5532,94,84,1645.89,3.4
"2011","TN30 7","TN30 7","Total",3681,1768,1913,3677,4,74,5357.13,0.7
"2011","TN31 6","TN31 6","Total",6443,3149,3294,6319,124,110,8236.93,0.8
"2011","TN31 7","TN31 7","Total",7099,3432,3667,7053,46,56,5389.93,1.3
"2011","TN32 5","TN32 5","Total",5238,2577,2661,4850,388,161,8338.27,0.6
"2011","TN33 0","TN33 0","Total",8195,3908,4287,8049,146,196,4482.23,1.8
"2011","TN33 9","TN33 9","Total",4550,2234,2316,4428,122,77,7175.89,0.6
"2011","TN34 1","TN34 1","Total",5736,2912,2824,5671,65,40,127.26,45.1
"2011","TN34 2","TN34 2","Total",12297,5883,6414,12084,213,136,580.82,21.2
"2011","TN34 3","TN34 3","Total",11658,5644,6014,11526,132,88,185.10,63.0
"2011","TN35 4","TN35 4","Total",6721,3220,3501,6565,156,86,4198.70,1.6
"2011","TN35 5","TN35 5","Total",10486,5069,5417,10393,93,90,594.39,17.6
"2011","TN36 4","TN36 4","Total",2303,1102,1201,2300,3,24,2026.43,1.1
"2011","TN37 6","TN37 6","Total",10187,5216,4971,9942,245,49,159.22,64.0
"2011","TN37 7","TN37 7","Total",10374,4975,5399,10258,116,113,517.00,20.1
"2011","TN38 0","TN38 0","Total",14113,6872,7241,13291,822,117,290.14,48.6
"2011","TN38 8","TN38 8","Total",4684,2264,2420,4684,0,49,291.63,16.1
"2011","TN38 9","TN38 9","Total",10238,4949,5289,10225,13,74,395.05,25.9
"2011","TN39 3","TN39 3","Total",10315,4763,5552,10126,189,116,324.52,31.8
"2011","TN39 4","TN39 4","Total",9871,4607,5264,9729,142,110,1109.55,8.9
"2011","TN39 5","TN39 5","Total",5582,2577,3005,5524,58,44,1070.64,5.2
"2011","TN4  0","TN4  0","Total",9053,4418,4635,8946,107,178,665.97,13.6
"2011","TN4  8","TN4  8","Total",9096,4450,4646,8915,181,175,474.05,19.2
"2011","TN4  9","TN4  9","Total",14090,6992,7098,14010,80,290,478.73,29.4
"2011","TN40 1","TN40 1","Total",7293,3268,4025,6865,428,50,159.66,45.7
"2011","TN40 2","TN40 2","Total",10129,4793,5336,9680,449,92,528.60,19.2
"2011","TN5  6","TN5  6","Total",4883,2331,2552,4821,62,191,4013.75,1.2
"2011","TN5  7","TN5  7","Total",3873,1894,1979,3802,71,100,3252.23,1.2
"2011","TN6  1","TN6  1","Total",8075,3973,4102,7824,251,190,1883.50,4.3
"2011","TN6  2","TN6  2","Total",10317,5111,5206,10307,10,194,507.74,20.3
"2011","TN6  3","TN6  3","Total",6038,2907,3131,5638,400,134,3716.97,1.6
"2011","TN7  4","TN7  4","Total",2151,1081,1070,2117,34,66,3852.33,0.6
"2011","TN8  5","TN8  5","Total",5213,2497,2716,5117,96,56,1265.01,4.1
"2011","TN8  6","TN8  6","Total",4838,2341,2497,4838,0,92,2201.45,2.2
"2011","TN8  7","TN8  7","Total",2629,1275,1354,2606,23,103,4445.64,0.6
"2011","TN9  1","TN9  1","Total",7019,3681,3338,6522,497,164,454.10,15.5
"2011","TN9  2","TN9  2","Total",11016,5425,5591,10972,44,188,610.78,18.0
"2011","TQ1  1","TQ1  1","Total",8188,4043,4145,7937,251,71,157.78,51.9
"2011","TQ1  2","TQ1  2","Total",4401,2140,2261,4232,169,61,283.02,15.6
"2011","TQ1  3","TQ1  3","Total",8995,4271,4724,8524,471,81,210.66,42.7
"2011","TQ1  4","TQ1  4","Total",10117,4983,5134,9889,228,93,519.37,19.5
"2011","TQ10 9","TQ10 9","Total",4029,1903,2126,3949,80,70,7928.21,0.5
"2011","TQ11 0","TQ11 0","Total",4133,2011,2122,4017,116,49,4052.97,1.0
"2011","TQ12 1","TQ12 1","Total",11294,5414,5880,10995,299,148,581.92,19.4
"2011","TQ12 2","TQ12 2","Total",5195,2545,2650,5161,34,56,188.11,27.6
"2011","TQ12 3","TQ12 3","Total",10451,5036,5415,10368,83,86,847.96,12.3
"2011","TQ12 4","TQ12 4","Total",8588,4220,4368,8588,0,145,2051.55,4.2
"2011","TQ12 5","TQ12 5","Total",8912,4243,4669,8847,65,128,2350.92,3.8
"2011","TQ12 6","TQ12 6","Total",8554,4544,4010,7653,901,134,6090.20,1.4
"2011","TQ13 0","TQ13 0","Total",6075,2998,3077,6009,66,99,3547.87,1.7
"2011","TQ13 7","TQ13 7","Total",5492,2628,2864,5431,61,103,11969.15,0.5
"2011","TQ13 8","TQ13 8","Total",3836,1842,1994,3758,78,91,11103.20,0.3
"2011","TQ13 9","TQ13 9","Total",7731,3712,4019,7639,92,141,9826.03,0.8
"2011","TQ14 0","TQ14 0","Total",1762,843,919,1726,36,27,303.78,5.8
"2011","TQ14 8","TQ14 8","Total",7484,3540,3944,7187,297,78,389.74,19.2
"2011","TQ14 9","TQ14 9","Total",10215,4859,5356,9943,272,128,1867.08,5.5
"2011","TQ2  5","TQ2  5","Total",4816,2542,2274,4441,375,37,109.77,43.9
"2011","TQ2  6","TQ2  6","Total",10317,4929,5388,10155,162,143,723.61,14.3
"2011","TQ2  7","TQ2  7","Total",10884,5226,5658,10739,145,135,467.57,23.3
"2011","TQ2  8","TQ2  8","Total",7527,3590,3937,7503,24,62,206.65,36.4
"2011","TQ3  1","TQ3  1","Total",8322,4032,4290,8274,48,113,1077.54,7.7
"2011","TQ3  2","TQ3  2","Total",8401,3963,4438,8068,333,70,168.85,49.8
"2011","TQ3  3","TQ3  3","Total",13645,6587,7058,13529,116,97,682.14,20.0
"2011","TQ4  5","TQ4  5","Total",5806,2695,3111,5659,147,42,159.90,36.3
"2011","TQ4  6","TQ4  6","Total",4100,1929,2171,3800,300,28,198.20,20.7
"2011","TQ4  7","TQ4  7","Total",8741,4215,4526,8739,2,97,837.56,10.4
"2011","TQ5  0","TQ5  0","Total",5974,2892,3082,5856,118,67,1486.79,4.0
"2011","TQ5  8","TQ5  8","Total",5028,2384,2644,4951,77,41,125.51,40.1
"2011","TQ5  9","TQ5  9","Total",8302,3970,4332,8208,94,64,380.66,21.8
"2011","TQ6  0","TQ6  0","Total",3203,1662,1541,2933,270,45,4393.14,0.7
"2011","TQ6  9","TQ6  9","Total",5064,2469,2595,5042,22,53,742.53,6.8
"2011","TQ7  1","TQ7  1","Total",5887,2769,3118,5805,82,84,429.65,13.7
"2011","TQ7  2","TQ7  2","Total",3869,1858,2011,3868,1,66,7814.84,0.5
"2011","TQ7  3","TQ7  3","Total",3693,1766,1927,3604,89,74,5503.95,0.7
"2011","TQ7  4","TQ7  4","Total",3043,1466,1577,3010,33,64,6672.19,0.5
"2011","TQ8  8","TQ8  8","Total",2071,993,1078,2020,51,46,1284.86,1.6
"2011","TQ9  5","TQ9  5","Total",8076,3760,4316,8024,52,115,599.13,13.5
"2011","TQ9  6","TQ9  6","Total",4674,2232,2442,4593,81,93,5819.41,0.8
"2011","TQ9  7","TQ9  7","Total",4509,2171,2338,4496,13,88,11463.35,0.4
"2011","TR1  1","TR1  1","Total",8673,4086,4587,8673,0,144,545.12,15.9
"2011","TR1  2","TR1  2","Total",3237,1543,1694,3235,2,63,234.12,13.8
"2011","TR1  3","TR1  3","Total",8624,4105,4519,8493,131,117,631.05,13.7
"2011","TR10 8","TR10 8","Total",7093,3482,3611,7093,0,59,338.06,21.0
"2011","TR10 9","TR10 9","Total",4165,2045,2120,3012,1153,42,2760.38,1.5
"2011","TR11 2","TR11 2","Total",8326,3933,4393,8326,0,68,167.73,49.6
"2011","TR11 3","TR11 3","Total",4708,2276,2432,4706,2,74,71.31,66.0
"2011","TR11 4","TR11 4","Total",6783,3211,3572,6783,0,71,314.87,21.5
"2011","TR11 5","TR11 5","Total",9009,4347,4662,8956,53,120,5914.81,1.5
"2011","TR12 6","TR12 6","Total",4128,2074,2054,4099,29,58,8869.68,0.5
"2011","TR12 7","TR12 7","Total",5456,2979,2477,4718,738,69,7394.95,0.7
"2011","TR13 0","TR13 0","Total",4280,2122,2158,4271,9,57,5237.94,0.8
"2011","TR13 8","TR13 8","Total",10090,4844,5246,10050,40,137,1040.13,9.7
"2011","TR13 9","TR13 9","Total",5453,2646,2807,5453,0,63,3125.96,1.7
"2011","TR14 0","TR14 0","Total",4673,2269,2404,4641,32,46,4538.14,1.0
"2011","TR14 7","TR14 7","Total",8751,4172,4579,8742,9,66,383.51,22.8
"2011","TR14 8","TR14 8","Total",8832,4324,4508,8768,64,54,226.93,38.9
"2011","TR14 9","TR14 9","Total",2376,1166,1210,2376,0,15,885.43,2.7
"2011","TR15 1","TR15 1","Total",6060,2910,3150,5975,85,31,482.99,12.5
"2011","TR15 2","TR15 2","Total",6140,3029,3111,6010,130,39,442.28,13.9
"2011","TR15 3","TR15 3","Total",7894,3883,4011,7891,3,52,964.24,8.2
"2011","TR16 4","TR16 4","Total",5380,2646,2734,5380,0,49,1731.17,3.1
"2011","TR16 5","TR16 5","Total",5115,2469,2646,5110,5,36,1279.95,4.0
"2011","TR16 6","TR16 6","Total",3665,1785,1880,3633,32,32,2340.07,1.6
"2011","TR17 0","TR17 0","Total",1447,670,777,1390,57,9,299.53,4.8
"2011","TR18 2","TR18 2","Total",5246,2551,2695,5172,74,53,91.28,57.5
"2011","TR18 3","TR18 3","Total",6371,2978,3393,6243,128,60,438.08,14.5
"2011","TR18 4","TR18 4","Total",4719,2161,2558,4537,182,52,144.50,32.7
"2011","TR18 5","TR18 5","Total",3536,1709,1827,3484,52,35,249.15,14.2
"2011","TR19 6","TR19 6","Total",3300,1617,1683,3223,77,44,5037.23,0.7
"2011","TR19 7","TR19 7","Total",5733,2806,2927,5603,130,70,4546.95,1.3
"2011","TR2  4","TR2  4","Total",5322,2544,2778,5292,30,97,9256.63,0.6
"2011","TR2  5","TR2  5","Total",4143,1962,2181,4137,6,75,7564.88,0.5
"2011","TR20 8","TR20 8","Total",4709,2286,2423,4589,120,86,7458.60,0.6
"2011","TR20 9","TR20 9","Total",4584,2161,2423,4489,95,63,3032.90,1.5
"2011","TR21 0","TR21 0","Total",1723,858,865,1647,76,52,656.73,2.6
"2011","TR22 0","TR22 0","Total",169,85,84,168,1,13,322.48,0.5
"2011","TR24 0","TR24 0","Total",175,93,82,175,0,10,382.71,0.5
"2011","TR25 0","TR25 0","Total",136,66,70,133,3,4,275.55,0.5
"2011","TR26 1","TR26 1","Total",3741,1716,2025,3674,67,34,91.82,40.7
"2011","TR26 2","TR26 2","Total",6225,2965,3260,5974,251,77,518.38,12.0
"2011","TR26 3","TR26 3","Total",1676,806,870,1558,118,26,2900.16,0.6
"2011","TR27 4","TR27 4","Total",7292,3504,3788,7114,178,60,420.52,17.3
"2011","TR27 5","TR27 5","Total",4287,2095,2192,4162,125,27,3278.39,1.3
"2011","TR27 6","TR27 6","Total",3187,1561,1626,3172,15,44,2932.85,1.1
"2011","TR3  6","TR3  6","Total",7899,3768,4131,7899,0,145,4027.04,2.0
"2011","TR3  7","TR3  7","Total",4500,2195,2305,4483,17,70,2299.72,2.0
"2011","TR4  8","TR4  8","Total",6028,2842,3186,6028,0,72,3507.32,1.7
"2011","TR4  9","TR4  9","Total",5019,2517,2502,5019,0,75,9179.97,0.5
"2011","TR5  0","TR5  0","Total",3884,1834,2050,3884,0,67,1943.28,2.0
"2011","TR6  0","TR6  0","Total",3516,1701,1815,3516,0,41,953.12,3.7
"2011","TR7  1","TR7  1","Total",6213,3093,3120,5959,254,70,255.83,24.3
"2011","TR7  2","TR7  2","Total",8389,4071,4318,8265,124,78,258.84,32.4
"2011","TR7  3","TR7  3","Total",5587,2728,2859,5400,187,62,541.82,10.3
"2011","TR8  4","TR8  4","Total",3506,1719,1787,3279,227,34,5901.01,0.6
"2011","TR8  5","TR8  5","Total",4467,2190,2277,4453,14,70,7162.46,0.6
"2011","TR9  6","TR9  6","Total",8224,4026,4198,8139,85,81,4811.08,1.7
"2011","TS1  1","TS1  1","Total",148,93,55,148,0,0,2.92,50.7
"2011","TS1  2","TS1  2","Total",1453,815,638,1098,355,39,336.59,4.3
"2011","TS1  3","TS1  3","Total",5898,3244,2654,5187,711,51,55.70,105.9
"2011","TS1  4","TS1  4","Total",8514,4574,3940,8513,1,55,69.15,123.1
"2011","TS1  5","TS1  5","Total",1189,664,525,1189,0,2,59.80,19.9
"2011","TS10 1","TS10 1","Total",6995,3535,3460,6860,135,54,174.60,40.1
"2011","TS10 2","TS10 2","Total",11089,5381,5708,11045,44,149,586.55,18.9
"2011","TS10 3","TS10 3","Total",5437,2671,2766,5394,43,44,110.49,49.2
"2011","TS10 4","TS10 4","Total",8928,4217,4711,8798,130,52,193.18,46.2
"2011","TS10 5","TS10 5","Total",4624,2211,2413,4624,0,18,1877.54,2.5
"2011","TS11 6","TS11 6","Total",3893,1909,1984,3863,30,43,467.52,8.3
"2011","TS11 7","TS11 7","Total",4389,2087,2302,4389,0,40,329.42,13.3
"2011","TS11 8","TS11 8","Total",3663,1797,1866,3654,9,29,2732.57,1.3
"2011","TS12 1","TS12 1","Total",5958,2872,3086,5717,241,64,307.54,19.4
"2011","TS12 2","TS12 2","Total",12848,6291,6557,12816,32,108,2164.87,5.9
"2011","TS12 3","TS12 3","Total",3708,1870,1838,3682,26,19,3951.96,0.9
"2011","TS13 4","TS13 4","Total",7988,3988,4000,7906,82,31,4153.38,1.9
"2011","TS13 5","TS13 5","Total",2381,1180,1201,2371,10,29,4909.02,0.5
"2011","TS14 6","TS14 6","Total",6875,3303,3572,6780,95,67,2113.42,3.3
"2011","TS14 7","TS14 7","Total",5767,2818,2949,5674,93,76,1392.70,4.1
"2011","TS14 8","TS14 8","Total",4985,2421,2564,4919,66,91,1997.03,2.5
"2011","TS15 0","TS15 0","Total",2404,1193,1211,2404,0,70,3646.23,0.7
"2011","TS15 9","TS15 9","Total",10398,5267,5131,10070,328,192,2913.81,3.6
"2011","TS16 0","TS16 0","Total",7444,3608,3836,7338,106,129,1963.49,3.8
"2011","TS16 9","TS16 9","Total",3005,1447,1558,3005,0,54,254.13,11.8
"2011","TS17 0","TS17 0","Total",13994,6935,7059,13973,21,216,402.46,34.8
"2011","TS17 5","TS17 5","Total",10340,5122,5218,10303,37,125,347.10,29.8
"2011","TS17 6","TS17 6","Total",4371,2167,2204,3773,598,60,105.01,41.6
"2011","TS17 7","TS17 7","Total",2160,1048,1112,2122,38,14,236.57,9.1
"2011","TS17 8","TS17 8","Total",6499,3194,3305,6455,44,39,147.97,43.9
"2011","TS17 9","TS17 9","Total",7755,3683,4072,7684,71,36,346.39,22.4
"2011","TS18 1","TS18 1","Total",2329,1219,1110,2277,52,17,55.68,41.8
"2011","TS18 2","TS18 2","Total",3341,2061,1280,2338,1003,15,398.20,8.4
"2011","TS18 3","TS18 3","Total",6007,3116,2891,5609,398,56,460.54,13.0
"2011","TS18 4","TS18 4","Total",6292,3117,3175,6235,57,79,200.17,31.4
"2011","TS18 5","TS18 5","Total",6908,3339,3569,6853,55,93,432.90,16.0
"2011","TS19 0","TS19 0","Total",12340,5944,6396,12277,63,79,309.72,39.8
"2011","TS19 7","TS19 7","Total",8982,4265,4717,8889,93,101,293.48,30.6
"2011","TS19 8","TS19 8","Total",10013,4795,5218,9924,89,50,325.79,30.7
"2011","TS19 9","TS19 9","Total",5780,2775,3005,5753,27,18,137.73,42.0
"2011","TS2  1","TS2  1","Total",773,380,393,773,0,5,2250.84,0.3
"2011","TS20 1","TS20 1","Total",11234,5482,5752,11214,20,130,360.93,31.1
"2011","TS20 2","TS20 2","Total",9503,4711,4792,9306,197,55,251.32,37.8
"2011","TS21 1","TS21 1","Total",3934,1957,1977,3853,81,60,5986.82,0.7
"2011","TS21 2","TS21 2","Total",2977,1467,1510,2977,0,59,3690.19,0.8
"2011","TS21 3","TS21 3","Total",3171,1547,1624,3110,61,32,6670.44,0.5
"2011","TS21 4","TS21 4","Total",2588,1248,1340,2588,0,25,992.27,2.6
"2011","TS22 5","TS22 5","Total",8506,4163,4343,8468,38,136,2993.87,2.8
"2011","TS23 1","TS23 1","Total",5989,2941,3048,5896,93,46,626.97,9.6
"2011","TS23 2","TS23 2","Total",7748,3645,4103,7734,14,45,168.44,46.0
"2011","TS23 3","TS23 3","Total",14796,7164,7632,14633,163,148,423.25,35.0
"2011","TS23 4","TS23 4","Total",1692,827,865,1692,0,10,215.66,7.8
"2011","TS24 0","TS24 0","Total",6441,3288,3153,6335,106,34,287.97,22.4
"2011","TS24 7","TS24 7","Total",1320,668,652,1320,0,8,69.55,19.0
"2011","TS24 8","TS24 8","Total",6147,2999,3148,6138,9,29,178.59,34.4
"2011","TS24 9","TS24 9","Total",7932,3818,4114,7843,89,55,338.46,23.4
"2011","TS25 1","TS25 1","Total",9183,4426,4757,9049,134,80,1605.08,5.7
"2011","TS25 2","TS25 2","Total",7798,3794,4004,7762,36,102,1352.96,5.8
"2011","TS25 3","TS25 3","Total",5621,2662,2959,5615,6,18,106.26,52.9
"2011","TS25 4","TS25 4","Total",5822,2751,3071,5694,128,39,176.20,33.0
"2011","TS25 5","TS25 5","Total",10403,4998,5405,10278,125,69,238.52,43.6
"2011","TS26 0","TS26 0","Total",12751,6123,6628,12668,83,161,634.87,20.1
"2011","TS26 8","TS26 8","Total",5546,2814,2732,5539,7,40,66.49,83.4
"2011","TS26 9","TS26 9","Total",7153,3553,3600,6977,176,78,119.81,59.7
"2011","TS27 3","TS27 3","Total",5389,2603,2786,5389,0,59,2233.41,2.4
"2011","TS27 4","TS27 4","Total",6938,3370,3568,6890,48,45,3251.93,2.1
"2011","TS28 5","TS28 5","Total",5277,2545,2732,5257,20,41,1435.10,3.7
"2011","TS29 6","TS29 6","Total",6266,3061,3205,6194,72,39,1226.65,5.1
"2011","TS3  0","TS3  0","Total",7213,3452,3761,7163,50,24,149.90,48.1
"2011","TS3  6","TS3  6","Total",3122,1528,1594,3122,0,13,56.54,55.2
"2011","TS3  7","TS3  7","Total",7171,3274,3897,7095,76,21,162.51,44.1
"2011","TS3  8","TS3  8","Total",4484,1988,2496,4448,36,13,107.18,41.8
"2011","TS3  9","TS3  9","Total",7663,3646,4017,7655,8,16,228.19,33.6
"2011","TS4  2","TS4  2","Total",8428,4191,4237,8300,128,27,281.59,29.9
"2011","TS4  3","TS4  3","Total",8801,4218,4583,8512,289,59,384.65,22.9
"2011","TS5  4","TS5  4","Total",5796,2751,3045,5788,8,20,229.81,25.2
"2011","TS5  5","TS5  5","Total",8076,4048,4028,7990,86,99,147.50,54.8
"2011","TS5  6","TS5  6","Total",7896,3895,4001,7764,132,62,142.96,55.2
"2011","TS5  7","TS5  7","Total",6444,3140,3304,6438,6,88,208.10,31.0
"2011","TS5  8","TS5  8","Total",11505,5517,5988,11498,7,87,606.62,19.0
"2011","TS6  0","TS6  0","Total",10184,4952,5232,10163,21,83,485.17,21.0
"2011","TS6  6","TS6  6","Total",3150,1543,1607,3073,77,11,348.88,9.0
"2011","TS6  7","TS6  7","Total",4725,2211,2514,4725,0,12,182.65,25.9
"2011","TS6  8","TS6  8","Total",2917,1361,1556,2834,83,10,301.28,9.7
"2011","TS6  9","TS6  9","Total",9374,4528,4846,9333,41,41,207.91,45.1
"2011","TS7  0","TS7  0","Total",6536,3194,3342,6487,49,114,786.61,8.3
"2011","TS7  8","TS7  8","Total",9241,4469,4772,9201,40,96,280.71,32.9
"2011","TS7  9","TS7  9","Total",6010,2888,3122,6010,0,39,289.22,20.8
"2011","TS8  0","TS8  0","Total",9474,4535,4939,9333,141,81,1642.50,5.8
"2011","TS8  9","TS8  9","Total",11537,5542,5995,11404,133,91,803.46,14.4
"2011","TS9  5","TS9  5","Total",5323,2496,2827,5323,0,104,1805.85,2.9
"2011","TS9  6","TS9  6","Total",5196,2544,2652,5195,1,97,5186.13,1.0
"2011","TS9  7","TS9  7","Total",2218,1111,1107,2217,1,52,9682.39,0.2
"2011","TW1  1","TW1  1","Total",8117,4084,4033,8105,12,159,131.72,61.6
"2011","TW1  2","TW1  2","Total",6153,3063,3090,6016,137,104,98.58,62.4
"2011","TW1  3","TW1  3","Total",3764,1865,1899,3744,20,77,68.72,54.8
"2011","TW1  4","TW1  4","Total",7358,3545,3813,6515,843,154,106.01,69.4
"2011","TW10 5","TW10 5","Total",2986,1418,1568,2986,0,67,355.40,8.4
"2011","TW10 6","TW10 6","Total",8397,4111,4286,8022,375,149,200.68,41.8
"2011","TW10 7","TW10 7","Total",7769,3754,4015,7748,21,142,583.35,13.3
"2011","TW11 0","TW11 0","Total",6598,3208,3390,6488,110,147,389.70,16.9
"2011","TW11 8","TW11 8","Total",8507,4101,4406,8498,9,141,118.78,71.6
"2011","TW11 9","TW11 9","Total",8305,3992,4313,8228,77,204,161.98,51.3
"2011","TW12 1","TW12 1","Total",7030,3400,3630,6915,115,145,159.83,44.0
"2011","TW12 2","TW12 2","Total",9427,4512,4915,9310,117,226,340.07,27.7
"2011","TW12 3","TW12 3","Total",6553,3119,3434,6512,41,123,131.21,49.9
"2011","TW13 4","TW13 4","Total",12679,6383,6296,12511,168,83,294.67,43.0
"2011","TW13 5","TW13 5","Total",9537,4739,4798,9537,0,69,240.65,39.6
"2011","TW13 6","TW13 6","Total",8306,4058,4248,8289,17,61,308.13,27.0
"2011","TW13 7","TW13 7","Total",5736,2838,2898,5736,0,41,180.59,31.8
"2011","TW14 0","TW14 0","Total",6093,3020,3073,6093,0,52,236.40,25.8
"2011","TW14 8","TW14 8","Total",9711,4765,4946,9693,18,71,392.37,24.7
"2011","TW14 9","TW14 9","Total",12219,6051,6168,12067,152,94,225.96,54.1
"2011","TW15 1","TW15 1","Total",10483,5136,5347,10483,0,95,228.78,45.8
"2011","TW15 2","TW15 2","Total",8024,3935,4089,7968,56,89,180.45,44.5
"2011","TW15 3","TW15 3","Total",8955,4412,4543,8673,282,99,248.31,36.1
"2011","TW16 5","TW16 5","Total",5046,2457,2589,5046,0,78,302.59,16.7
"2011","TW16 6","TW16 6","Total",5601,2731,2870,5515,86,83,228.76,24.5
"2011","TW16 7","TW16 7","Total",9496,4727,4769,9407,89,75,221.85,42.8
"2011","TW17 0","TW17 0","Total",5308,2629,2679,5308,0,48,347.75,15.3
"2011","TW17 8","TW17 8","Total",6423,3129,3294,6377,46,83,407.25,15.8
"2011","TW17 9","TW17 9","Total",2511,1222,1289,2511,0,45,321.69,7.8
"2011","TW18 1","TW18 1","Total",8919,4342,4577,8800,119,93,532.24,16.8
"2011","TW18 2","TW18 2","Total",7545,3666,3879,7545,0,88,239.78,31.5
"2011","TW18 3","TW18 3","Total",4396,2189,2207,4392,4,49,227.51,19.3
"2011","TW18 4","TW18 4","Total",5313,2700,2613,5282,31,57,504.09,10.5
"2011","TW19 5","TW19 5","Total",3954,1974,1980,3947,7,70,654.36,6.0
"2011","TW19 6","TW19 6","Total",1371,696,675,1371,0,10,262.96,5.2
"2011","TW19 7","TW19 7","Total",10694,5316,5378,10642,52,66,468.32,22.8
"2011","TW2  5","TW2  5","Total",9427,4604,4823,9427,0,174,206.98,45.5
"2011","TW2  6","TW2  6","Total",10633,5236,5397,10581,52,144,200.28,53.1
"2011","TW2  7","TW2  7","Total",10585,5205,5380,10433,152,146,208.05,50.9
"2011","TW20 0","TW20 0","Total",10297,4811,5486,7898,2399,219,867.42,11.9
"2011","TW20 8","TW20 8","Total",7854,3889,3965,7706,148,127,899.65,8.7
"2011","TW20 9","TW20 9","Total",6694,3156,3538,6694,0,83,317.58,21.1
"2011","TW3  1","TW3  1","Total",8341,4460,3881,8310,31,55,92.34,90.3
"2011","TW3  2","TW3  2","Total",10436,5257,5179,10417,19,147,125.92,82.9
"2011","TW3  3","TW3  3","Total",12504,6490,6014,12410,94,115,135.40,92.3
"2011","TW3  4","TW3  4","Total",8887,4647,4240,8883,4,112,133.24,66.7
"2011","TW4  5","TW4  5","Total",9918,4982,4936,9909,9,77,254.84,38.9
"2011","TW4  6","TW4  6","Total",5731,3016,2715,5542,189,58,172.26,33.3
"2011","TW4  7","TW4  7","Total",11580,5881,5699,11547,33,122,137.25,84.4
"2011","TW5  0","TW5  0","Total",13955,7107,6848,13871,84,198,244.28,57.1
"2011","TW5  9","TW5  9","Total",15508,7871,7637,15507,1,215,382.41,40.6
"2011","TW7  4","TW7  4","Total",7975,4138,3837,7937,38,106,169.98,46.9
"2011","TW7  5","TW7  5","Total",9162,4588,4574,9154,8,133,491.17,18.7
"2011","TW7  6","TW7  6","Total",10529,5077,5452,10403,126,104,173.24,60.8
"2011","TW7  7","TW7  7","Total",9874,4768,5106,9874,0,102,166.60,59.3
"2011","TW8  0","TW8  0","Total",8715,4278,4437,8714,1,84,121.89,71.5
"2011","TW8  8","TW8  8","Total",5007,2423,2584,4928,79,47,158.22,31.6
"2011","TW8  9","TW8  9","Total",5945,2934,3011,5149,796,88,117.43,50.6
"2011","TW9  1","TW9  1","Total",4073,2008,2065,4067,6,71,74.74,54.5
"2011","TW9  2","TW9  2","Total",6466,3155,3311,6456,10,87,212.96,30.4
"2011","TW9  3","TW9  3","Total",4529,2196,2333,4429,100,130,203.12,22.3
"2011","TW9  4","TW9  4","Total",6563,3242,3321,6563,0,120,129.26,50.8
"2011","UB1  1","UB1  1","Total",10330,5530,4800,10148,182,85,120.21,85.9
"2011","UB1  2","UB1  2","Total",20011,10159,9852,19721,290,217,213.83,93.6
"2011","UB1  3","UB1  3","Total",10033,5106,4927,9361,672,97,195.65,51.3
"2011","UB10 0","UB10 0","Total",10714,5256,5458,10652,62,160,254.90,42.0
"2011","UB10 8","UB10 8","Total",12043,5901,6142,11994,49,246,669.16,18.0
"2011","UB10 9","UB10 9","Total",10737,5272,5465,10718,19,180,383.88,28.0
"2011","UB2  4","UB2  4","Total",12999,6524,6475,12761,238,148,359.17,36.2
"2011","UB2  5","UB2  5","Total",19240,10090,9150,19231,9,197,276.73,69.5
"2011","UB3  1","UB3  1","Total",9967,5047,4920,9775,192,117,383.92,26.0
"2011","UB3  2","UB3  2","Total",14063,6978,7085,13954,109,129,210.45,66.8
"2011","UB3  3","UB3  3","Total",7647,3887,3760,7635,12,62,239.86,31.9
"2011","UB3  4","UB3  4","Total",10406,5193,5213,10390,16,71,160.72,64.7
"2011","UB3  5","UB3  5","Total",6050,3128,2922,6046,4,65,414.97,14.6
"2011","UB4  0","UB4  0","Total",14378,7390,6988,14341,37,141,214.13,67.1
"2011","UB4  8","UB4  8","Total",13011,6493,6518,12942,69,132,307.03,42.4
"2011","UB4  9","UB4  9","Total",12227,5901,6326,12214,13,75,218.22,56.0
"2011","UB5  4","UB5  4","Total",16225,8043,8182,16213,12,181,241.87,67.1
"2011","UB5  5","UB5  5","Total",12826,6252,6574,12814,12,123,321.59,39.9
"2011","UB5  6","UB5  6","Total",16904,8163,8741,16904,0,161,316.33,53.4
"2011","UB6  0","UB6  0","Total",12639,6420,6219,12532,107,138,278.95,45.3
"2011","UB6  7","UB6  7","Total",8723,4519,4204,8723,0,81,149.67,58.3
"2011","UB6  8","UB6  8","Total",14624,7417,7207,14582,42,181,424.33,34.5
"2011","UB6  9","UB6  9","Total",15378,7652,7726,15265,113,189,245.77,62.6
"2011","UB7  0","UB7  0","Total",3777,2120,1657,3494,283,33,1888.01,2.0
"2011","UB7  7","UB7  7","Total",9033,4465,4568,8882,151,59,304.05,29.7
"2011","UB7  8","UB7  8","Total",7132,3548,3584,7123,9,42,192.42,37.1
"2011","UB7  9","UB7  9","Total",9710,4703,5007,9652,58,88,208.71,46.5
"2011","UB8  1","UB8  1","Total",5018,2547,2471,4977,41,72,192.84,26.0
"2011","UB8  2","UB8  2","Total",12336,6311,6025,11265,1071,136,336.75,36.6
"2011","UB8  3","UB8  3","Total",19250,9825,9425,15892,3358,218,445.36,43.2
"2011","UB9  4","UB9  4","Total",2411,1229,1182,2411,0,44,691.08,3.5
"2011","UB9  5","UB9  5","Total",4728,2259,2469,4639,89,72,911.09,5.2
"2011","UB9  6","UB9  6","Total",7399,3565,3834,7181,218,67,1522.44,4.9
"2011","W10  4","W10  4","Total",10506,4965,5541,10446,60,80,53.27,197.2
"2011","W10  5","W10  5","Total",11896,5802,6094,11885,11,107,113.25,105.0
"2011","W10  6","W10  6","Total",11800,5569,6231,11663,137,145,95.36,123.7
"2011","W11  1","W11  1","Total",10660,5150,5510,10589,71,114,47.16,226.0
"2011","W11  2","W11  2","Total",7039,3314,3725,7028,11,155,43.16,163.1
"2011","W11  3","W11  3","Total",4796,2343,2453,4630,166,138,48.97,97.9
"2011","W11  4","W11  4","Total",9004,4362,4642,8998,6,150,62.91,143.1
"2011","W12  0","W12  0","Total",14703,6983,7720,14347,356,116,250.31,58.7
"2011","W12  7","W12  7","Total",11324,5361,5963,11314,10,108,110.77,102.2
"2011","W12  8","W12  8","Total",9038,4546,4492,8982,56,65,65.44,138.1
"2011","W12  9","W12  9","Total",13884,7001,6883,13609,275,195,95.05,146.1
"2011","W13  0","W13  0","Total",10500,5136,5364,10439,61,153,131.54,79.8
"2011","W13  8","W13  8","Total",7384,3647,3737,7317,67,152,116.75,63.2
"2011","W13  9","W13  9","Total",14527,7247,7280,14435,92,213,135.89,106.9
"2011","W14  0","W14  0","Total",11591,5612,5979,11514,77,159,63.16,183.5
"2011","W14  8","W14  8","Total",11738,5671,6067,11727,11,199,107.04,109.7
"2011","W14  9","W14  9","Total",14151,7108,7043,14074,77,93,76.35,185.3
"2011","W1B  1","W1B  1","Total",508,260,248,508,0,9,7.58,67.0
"2011","W1D  3","W1D  3","Total",252,167,85,209,43,0,9.21,27.4
"2011","W1D  4","W1D  4","Total",415,292,123,411,4,0,4.50,92.2
"2011","W1D  6","W1D  6","Total",656,408,248,625,31,6,10.76,61.0
"2011","W1D  7","W1D  7","Total",221,137,84,220,1,4,10.52,21.0
"2011","W1F  0","W1F  0","Total",979,586,393,975,4,10,8.24,118.8
"2011","W1F  7","W1F  7","Total",531,320,211,531,0,4,11.21,47.4
"2011","W1G  6","W1G  6","Total",847,428,419,793,54,11,8.17,103.7
"2011","W1G  7","W1G  7","Total",323,185,138,323,0,2,3.78,85.4
"2011","W1G  8","W1G  8","Total",1431,758,673,1431,0,13,12.64,113.2
"2011","W1G  9","W1G  9","Total",330,184,146,324,6,2,12.39,26.6
"2011","W1H  1","W1H  1","Total",1114,598,516,1088,26,15,9.61,115.9
"2011","W1H  2","W1H  2","Total",1862,979,883,1862,0,33,9.09,204.8
"2011","W1H  4","W1H  4","Total",782,390,392,770,12,11,4.02,194.5
"2011","W1H  5","W1H  5","Total",1210,655,555,1044,166,49,5.50,220.0
"2011","W1H  7","W1H  7","Total",1321,749,572,1316,5,15,13.53,97.6
"2011","W1J  5","W1J  5","Total",309,165,144,307,2,5,6.02,51.3
"2011","W1J  6","W1J  6","Total",152,97,55,152,0,2,14.04,10.8
"2011","W1J  7","W1J  7","Total",787,465,322,787,0,6,16.46,47.8
"2011","W1J  8","W1J  8","Total",280,160,120,280,0,0,16.17,17.3
"2011","W1K  1","W1K  1","Total",318,169,149,316,2,6,5.69,55.9
"2011","W1K  2","W1K  2","Total",599,355,244,578,21,14,15.17,39.5
"2011","W1K  3","W1K  3","Total",287,143,144,287,0,3,4.52,63.5
"2011","W1K  4","W1K  4","Total",144,79,65,144,0,0,4.13,34.9
"2011","W1K  5","W1K  5","Total",232,128,104,232,0,2,3.67,63.2
"2011","W1K  6","W1K  6","Total",847,440,407,845,2,10,9.98,84.9
"2011","W1K  7","W1K  7","Total",588,341,247,588,0,12,7.32,80.3
"2011","W1S  1","W1S  1","Total",151,97,54,151,0,0,10.29,14.7
"2011","W1T  1","W1T  1","Total",454,276,178,454,0,4,6.42,70.7
"2011","W1T  2","W1T  2","Total",636,349,287,636,0,3,6.97,91.2
"2011","W1T  3","W1T  3","Total",207,137,70,207,0,0,5.89,35.1
"2011","W1T  4","W1T  4","Total",702,392,310,393,309,6,3.74,187.7
"2011","W1T  5","W1T  5","Total",1809,1030,779,1335,474,19,11.43,158.3
"2011","W1T  6","W1T  6","Total",252,154,98,252,0,1,1.04,242.3
"2011","W1U  1","W1U  1","Total",357,180,177,349,8,9,6.85,52.1
"2011","W1U  2","W1U  2","Total",247,122,125,247,0,5,3.19,77.4
"2011","W1U  3","W1U  3","Total",543,289,254,542,1,4,12.50,43.4
"2011","W1U  4","W1U  4","Total",1156,610,546,1156,0,19,7.49,154.3
"2011","W1U  5","W1U  5","Total",1273,675,598,1138,135,29,8.00,159.1
"2011","W1U  6","W1U  6","Total",1320,711,609,1320,0,13,7.67,172.1
"2011","W1U  8","W1U  8","Total",755,429,326,751,4,5,9.00,83.9
"2011","W1W  5","W1W  5","Total",1532,764,768,1273,259,29,6.56,233.5
"2011","W1W  6","W1W  6","Total",2030,1024,1006,1712,318,33,13.66,148.6
"2011","W1W  7","W1W  7","Total",872,501,371,822,50,5,10.28,84.8
"2011","W2   1","W2   1","Total",7437,3989,3448,6948,489,110,63.06,117.9
"2011","W2   2","W2   2","Total",5924,3173,2751,5866,58,137,38.42,154.2
"2011","W2   3","W2   3","Total",7567,4056,3511,7265,302,101,38.44,196.9
"2011","W2   4","W2   4","Total",7975,4128,3847,7685,290,111,40.26,198.1
"2011","W2   5","W2   5","Total",11008,5480,5528,10837,171,148,57.11,192.8
"2011","W2   6","W2   6","Total",8461,4286,4175,8454,7,75,53.74,157.4
"2011","W3   0","W3   0","Total",6796,3505,3291,6769,27,57,215.43,31.5
"2011","W3   6","W3   6","Total",12772,6517,6255,12704,68,115,141.43,90.3
"2011","W3   7","W3   7","Total",13762,6833,6929,13748,14,131,160.93,85.5
"2011","W3   8","W3   8","Total",11021,5322,5699,10795,226,113,115.01,95.8
"2011","W3   9","W3   9","Total",8068,4025,4043,7992,76,119,122.20,66.0
"2011","W4   1","W4   1","Total",8352,4034,4318,8346,6,195,93.59,89.2
"2011","W4   2","W4   2","Total",9953,4851,5102,9867,86,152,187.06,53.2
"2011","W4   3","W4   3","Total",11543,5781,5762,11543,0,247,192.40,60.0
"2011","W4   4","W4   4","Total",5135,2595,2540,5118,17,88,65.23,78.7
"2011","W4   5","W4   5","Total",9035,4411,4624,8983,52,71,122.17,74.0
"2011","W5   1","W5   1","Total",10117,4946,5171,9897,220,190,178.90,56.6
"2011","W5   2","W5   2","Total",10175,5059,5116,9703,472,172,175.10,58.1
"2011","W5   3","W5   3","Total",10249,5079,5170,10107,142,168,167.34,61.2
"2011","W5   4","W5   4","Total",14521,7255,7266,14258,263,172,256.08,56.7
"2011","W5   5","W5   5","Total",4881,2416,2465,4738,143,47,83.28,58.6
"2011","W6   0","W6   0","Total",12160,6008,6152,11941,219,192,99.04,122.8
"2011","W6   7","W6   7","Total",6062,2965,3097,5942,120,101,61.06,99.3
"2011","W6   8","W6   8","Total",8872,4337,4535,8763,109,63,66.30,133.8
"2011","W6   9","W6   9","Total",8634,4277,4357,8531,103,116,80.61,107.1
"2011","W7   1","W7   1","Total",9780,4623,5157,9717,63,124,98.57,99.2
"2011","W7   2","W7   2","Total",7737,3737,4000,7682,55,108,135.14,57.3
"2011","W7   3","W7   3","Total",11442,5635,5807,11395,47,146,193.03,59.3
"2011","W8   4","W8   4","Total",3714,1820,1894,3633,81,79,53.60,69.3
"2011","W8   5","W8   5","Total",4982,2435,2547,4781,201,134,37.84,131.7
"2011","W8   6","W8   6","Total",5993,2990,3003,5837,156,162,36.62,163.7
"2011","W8   7","W8   7","Total",5847,2825,3022,5702,145,184,50.66,115.4
"2011","W9   1","W9   1","Total",13037,6346,6691,13024,13,225,79.54,163.9
"2011","W9   2","W9   2","Total",11046,5518,5528,10927,119,114,53.69,205.7
"2011","W9   3","W9   3","Total",13486,6520,6966,13382,104,96,54.05,249.5
"2011","WA1  1","WA1  1","Total",809,467,342,790,19,6,217.65,3.7
"2011","WA1  2","WA1  2","Total",2214,1177,1037,2006,208,12,63.15,35.1
"2011","WA1  3","WA1  3","Total",10056,4940,5116,10041,15,78,315.54,31.9
"2011","WA1  4","WA1  4","Total",8454,4188,4266,8363,91,100,932.56,9.1
"2011","WA10 1","WA10 1","Total",2309,1195,1114,2309,0,10,65.69,35.1
"2011","WA10 2","WA10 2","Total",4791,2428,2363,4685,106,35,104.24,46.0
"2011","WA10 3","WA10 3","Total",9461,4669,4792,9410,51,68,296.76,31.9
"2011","WA10 4","WA10 4","Total",8230,4072,4158,8181,49,85,155.44,52.9
"2011","WA10 5","WA10 5","Total",6049,2953,3096,5992,57,86,589.48,10.3
"2011","WA10 6","WA10 6","Total",7808,3832,3976,7745,63,84,659.01,11.8
"2011","WA11 0","WA11 0","Total",16250,7963,8287,16186,64,119,1121.16,14.5
"2011","WA11 7","WA11 7","Total",6603,3211,3392,6585,18,55,1970.00,3.4
"2011","WA11 8","WA11 8","Total",5910,2792,3118,5865,45,99,1031.84,5.7
"2011","WA11 9","WA11 9","Total",11753,5799,5954,11733,20,77,483.80,24.3
"2011","WA12 0","WA12 0","Total",4310,2122,2188,4310,0,31,436.51,9.9
"2011","WA12 8","WA12 8","Total",7921,3853,4068,7823,98,72,348.78,22.7
"2011","WA12 9","WA12 9","Total",9802,4871,4931,9778,24,76,393.55,24.9
"2011","WA13 0","WA13 0","Total",6748,3269,3479,6662,86,163,1328.12,5.1
"2011","WA13 9","WA13 9","Total",6082,3011,3071,6079,3,132,1399.38,4.3
"2011","WA14 1","WA14 1","Total",3101,1527,1574,3095,6,42,60.05,51.6
"2011","WA14 2","WA14 2","Total",5621,2731,2890,5493,128,132,194.82,28.9
"2011","WA14 3","WA14 3","Total",4388,2137,2251,4320,68,154,376.67,11.6
"2011","WA14 4","WA14 4","Total",6833,3373,3460,6660,173,133,953.82,7.2
"2011","WA14 5","WA14 5","Total",7747,3837,3910,7747,0,74,772.79,10.0
"2011","WA15 0","WA15 0","Total",4983,2447,2536,4971,12,212,1895.16,2.6
"2011","WA15 6","WA15 6","Total",12652,6212,6440,12607,45,231,297.99,42.5
"2011","WA15 7","WA15 7","Total",10409,5021,5388,10372,37,180,254.22,40.9
"2011","WA15 8","WA15 8","Total",8834,4263,4571,8781,53,214,516.92,17.1
"2011","WA15 9","WA15 9","Total",5786,2832,2954,5786,0,208,137.44,42.1
"2011","WA16 0","WA16 0","Total",5896,2846,3050,5837,59,135,5147.30,1.1
"2011","WA16 6","WA16 6","Total",2946,1407,1539,2888,58,59,2360.43,1.2
"2011","WA16 7","WA16 7","Total",3308,1575,1733,3126,182,61,2373.85,1.4
"2011","WA16 8","WA16 8","Total",7640,3709,3931,7592,48,137,1419.36,5.4
"2011","WA16 9","WA16 9","Total",3754,1842,1912,3719,35,89,3280.52,1.1
"2011","WA2  0","WA2  0","Total",17665,8626,9039,17349,316,161,620.56,28.5
"2011","WA2  7","WA2  7","Total",7446,3769,3677,7426,20,41,150.27,49.6
"2011","WA2  8","WA2  8","Total",5877,2920,2957,5707,170,56,877.94,6.7
"2011","WA2  9","WA2  9","Total",9804,4712,5092,9797,7,40,158.70,61.8
"2011","WA3  1","WA3  1","Total",3351,1685,1666,3318,33,34,819.60,4.1
"2011","WA3  2","WA3  2","Total",9830,4803,5027,9806,24,103,388.56,25.3
"2011","WA3  3","WA3  3","Total",10225,5053,5172,10188,37,70,718.02,14.2
"2011","WA3  4","WA3  4","Total",4627,2194,2433,4572,55,110,443.64,10.4
"2011","WA3  5","WA3  5","Total",4503,2194,2309,4503,0,78,1292.90,3.5
"2011","WA3  6","WA3  6","Total",10612,5806,4806,9533,1079,87,1809.98,5.9
"2011","WA3  7","WA3  7","Total",4609,2272,2337,4565,44,82,1049.24,4.4
"2011","WA4  1","WA4  1","Total",10003,5037,4966,9907,96,55,314.15,31.8
"2011","WA4  2","WA4  2","Total",13222,6452,6770,13066,156,246,366.82,36.0
"2011","WA4  3","WA4  3","Total",4203,2028,2175,4125,78,65,780.11,5.4
"2011","WA4  4","WA4  4","Total",3328,1786,1542,3027,301,91,3711.43,0.9
"2011","WA4  5","WA4  5","Total",7246,3552,3694,7246,0,246,1060.81,6.8
"2011","WA4  6","WA4  6","Total",8671,4294,4377,8652,19,110,1006.00,8.6
"2011","WA5  0","WA5  0","Total",5958,2989,2969,5915,43,19,239.15,24.9
"2011","WA5  1","WA5  1","Total",13192,6507,6685,13147,45,118,434.84,30.3
"2011","WA5  2","WA5  2","Total",10146,4886,5260,9985,161,127,1409.31,7.2
"2011","WA5  3","WA5  3","Total",11179,5548,5631,11076,103,164,411.97,27.1
"2011","WA5  4","WA5  4","Total",3913,1899,2014,3794,119,24,1054.57,3.7
"2011","WA5  7","WA5  7","Total",1726,877,849,1726,0,34,207.46,8.3
"2011","WA5  8","WA5  8","Total",6847,3401,3446,6842,5,99,173.72,39.4
"2011","WA5  9","WA5  9","Total",5539,2721,2818,5378,161,108,261.40,21.2
"2011","WA6  0","WA6  0","Total",3853,1893,1960,3813,40,64,1187.03,3.2
"2011","WA6  6","WA6  6","Total",4690,2276,2414,4630,60,117,2337.09,2.0
"2011","WA6  7","WA6  7","Total",5451,2571,2880,5390,61,72,1185.88,4.6
"2011","WA6  8","WA6  8","Total",2474,1212,1262,2449,25,83,1330.01,1.9
"2011","WA6  9","WA6  9","Total",2457,1202,1255,2435,22,54,1144.62,2.1
"2011","WA7  1","WA7  1","Total",6194,3174,3020,6151,43,68,563.14,11.0
"2011","WA7  2","WA7  2","Total",15518,7611,7907,15450,68,117,744.16,20.9
"2011","WA7  3","WA7  3","Total",3534,1717,1817,3530,4,41,1530.82,2.3
"2011","WA7  4","WA7  4","Total",9182,4490,4692,9161,21,75,803.96,11.4
"2011","WA7  5","WA7  5","Total",13010,6289,6721,12834,176,72,295.30,44.1
"2011","WA7  6","WA7  6","Total",15833,7667,8166,15776,57,108,518.63,30.5
"2011","WA8  0","WA8  0","Total",3275,1623,1652,3237,38,17,398.86,8.2
"2011","WA8  3","WA8  3","Total",6701,3318,3383,6668,33,63,1561.90,4.3
"2011","WA8  4","WA8  4","Total",6861,3289,3572,6831,30,63,133.75,51.3
"2011","WA8  5","WA8  5","Total",2003,991,1012,2003,0,26,539.43,3.7
"2011","WA8  6","WA8  6","Total",7377,3597,3780,7287,90,43,169.77,43.5
"2011","WA8  7","WA8  7","Total",10689,5218,5471,10639,50,68,336.66,31.8
"2011","WA8  8","WA8  8","Total",12807,6084,6723,12602,205,77,940.43,13.6
"2011","WA8  9","WA8  9","Total",12221,6051,6170,12164,57,157,477.91,25.6
"2011","WA9  1","WA9  1","Total",5123,2470,2653,4885,238,19,209.63,24.4
"2011","WA9  2","WA9  2","Total",6723,3321,3402,6723,0,23,215.01,31.3
"2011","WA9  3","WA9  3","Total",11407,5580,5827,11365,42,62,407.52,28.0
"2011","WA9  4","WA9  4","Total",13584,6684,6900,13550,34,85,695.39,19.5
"2011","WA9  5","WA9  5","Total",12033,5897,6136,11913,120,115,773.84,15.5
"2011","WC1A 1","WC1A 1","Total",268,152,116,268,0,0,0.97,276.3
"2011","WC1A 2","WC1A 2","Total",277,138,139,277,0,1,1.36,203.7
"2011","WC1B 3","WC1B 3","Total",1091,536,555,928,163,8,27.53,39.6
"2011","WC1B 4","WC1B 4","Total",576,287,289,552,24,15,6.60,87.3
"2011","WC1E 6","WC1E 6","Total",1281,680,601,868,413,17,10.84,118.2
"2011","WC1E 7","WC1E 7","Total",1001,525,476,856,145,10,14.57,68.7
"2011","WC1H 0","WC1H 0","Total",1283,574,709,863,420,17,6.54,196.2
"2011","WC1H 8","WC1H 8","Total",2872,1430,1442,2812,60,19,16.16,177.7
"2011","WC1H 9","WC1H 9","Total",4173,2052,2121,2971,1202,28,19.36,215.5
"2011","WC1N 1","WC1N 1","Total",3196,1579,1617,2624,572,17,19.10,167.3
"2011","WC1N 2","WC1N 2","Total",1623,895,728,1467,156,18,9.66,168.0
"2011","WC1N 3","WC1N 3","Total",2476,1284,1192,2455,21,21,15.15,163.4
"2011","WC1R 4","WC1R 4","Total",630,333,297,629,1,14,10.89,57.9
"2011","WC1V 6","WC1V 6","Total",367,192,175,367,0,4,22.17,16.6
"2011","WC1V 7","WC1V 7","Total",593,314,279,237,356,4,1.84,322.3
"2011","WC1X 0","WC1X 0","Total",3337,1657,1680,2962,375,38,16.66,200.3
"2011","WC1X 8","WC1X 8","Total",311,179,132,311,0,0,1.76,176.7
"2011","WC1X 9","WC1X 9","Total",4305,2107,2198,3573,732,39,24.26,177.5
"2011","WC2B 4","WC2B 4","Total",652,350,302,526,126,2,1.27,513.4
"2011","WC2B 5","WC2B 5","Total",1255,742,513,1188,67,6,14.90,84.2
"2011","WC2E 7","WC2E 7","Total",641,346,295,568,73,6,40.72,15.7
"2011","WC2E 9","WC2E 9","Total",264,155,109,264,0,0,6.05,43.6
"2011","WC2H 0","WC2H 0","Total",778,448,330,778,0,1,7.52,103.5
"2011","WC2H 7","WC2H 7","Total",243,134,109,243,0,2,1.31,185.5
"2011","WC2H 8","WC2H 8","Total",197,105,92,197,0,6,4.80,41.0
"2011","WC2H 9","WC2H 9","Total",1273,663,610,1244,29,9,7.47,170.4
"2011","WC2N 4","WC2N 4","Total",279,171,108,238,41,1,6.57,42.5
"2011","WC2N 5","WC2N 5","Total",463,238,225,256,207,6,33.38,13.9
"2011","WC2N 6","WC2N 6","Total",290,163,127,290,0,0,7.52,38.6
"2011","WD17 1","WD17 1","Total",1087,607,480,1076,11,13,27.90,39.0
"2011","WD17 2","WD17 2","Total",3208,1659,1549,3165,43,13,74.14,43.3
"2011","WD17 3","WD17 3","Total",3886,1921,1965,3884,2,137,303.42,12.8
"2011","WD17 4","WD17 4","Total",7606,3735,3871,7358,248,149,179.01,42.5
"2011","WD18 0","WD18 0","Total",7819,4008,3811,7788,31,80,137.64,56.8
"2011","WD18 6","WD18 6","Total",4984,2327,2657,4883,101,37,147.76,33.7
"2011","WD18 7","WD18 7","Total",10891,5579,5312,10789,102,158,197.15,55.2
"2011","WD18 8","WD18 8","Total",640,338,302,640,0,8,75.52,8.5
"2011","WD19 4","WD19 4","Total",9844,4819,5025,9776,68,226,368.09,26.7
"2011","WD19 5","WD19 5","Total",4861,2304,2557,4839,22,81,234.82,20.7
"2011","WD19 6","WD19 6","Total",7094,3373,3721,7025,69,64,181.34,39.1
"2011","WD19 7","WD19 7","Total",5576,2716,2860,5575,1,44,179.29,31.1
"2011","WD23 1","WD23 1","Total",5754,2715,3039,5611,143,175,461.42,12.5
"2011","WD23 2","WD23 2","Total",8118,3960,4158,7887,231,165,414.44,19.6
"2011","WD23 3","WD23 3","Total",5457,2590,2867,5420,37,96,186.51,29.3
"2011","WD23 4","WD23 4","Total",6311,3064,3247,6268,43,142,350.14,18.0
"2011","WD24 4","WD24 4","Total",4148,2093,2055,4143,5,31,99.81,41.6
"2011","WD24 5","WD24 5","Total",6759,3380,3379,6692,67,71,106.53,63.4
"2011","WD24 6","WD24 6","Total",5170,2596,2574,5170,0,44,78.15,66.2
"2011","WD24 7","WD24 7","Total",5538,2799,2739,5538,0,79,126.30,43.8
"2011","WD25 0","WD25 0","Total",8042,3877,4165,8003,39,93,161.49,49.8
"2011","WD25 7","WD25 7","Total",8271,4040,4231,8224,47,95,386.59,21.4
"2011","WD25 8","WD25 8","Total",1355,697,658,1242,113,33,921.41,1.5
"2011","WD25 9","WD25 9","Total",10140,4852,5288,10125,15,97,293.08,34.6
"2011","WD3  1","WD3  1","Total",4323,2159,2164,4270,53,75,841.49,5.1
"2011","WD3  3","WD3  3","Total",11575,5558,6017,11545,30,278,354.71,32.6
"2011","WD3  4","WD3  4","Total",3722,1751,1971,3598,124,176,1419.57,2.6
"2011","WD3  5","WD3  5","Total",7451,3571,3880,7277,174,237,862.66,8.6
"2011","WD3  6","WD3  6","Total",1164,558,606,1164,0,24,893.62,1.3
"2011","WD3  7","WD3  7","Total",3560,1727,1833,3469,91,109,113.50,31.4
"2011","WD3  8","WD3  8","Total",6297,3059,3238,6285,12,55,198.27,31.8
"2011","WD3  9","WD3  9","Total",2574,1235,1339,2574,0,35,708.22,3.6
"2011","WD4  8","WD4  8","Total",7851,3827,4024,7800,51,109,1181.85,6.6
"2011","WD4  9","WD4  9","Total",3401,1695,1706,3401,0,95,1642.89,2.1
"2011","WD5  0","WD5  0","Total",11497,5641,5856,11396,101,172,522.80,22.0
"2011","WD6  1","WD6  1","Total",7324,3642,3682,7182,142,73,166.17,44.1
"2011","WD6  2","WD6  2","Total",8964,4414,4550,8959,5,101,216.05,41.5
"2011","WD6  3","WD6  3","Total",5422,2664,2758,5176,246,143,1051.90,5.2
"2011","WD6  4","WD6  4","Total",8412,3996,4416,8325,87,111,216.73,38.8
"2011","WD6  5","WD6  5","Total",7423,3594,3829,7381,42,77,331.66,22.4
"2011","WD7  7","WD7  7","Total",2941,1483,1458,2927,14,118,298.53,9.9
"2011","WD7  8","WD7  8","Total",5222,2555,2667,5221,1,173,633.12,8.2
"2011","WD7  9","WD7  9","Total",4306,2053,2253,4146,160,71,1261.72,3.4
"2011","WF1  1","WF1  1","Total",1152,633,519,1145,7,2,45.88,25.1
"2011","WF1  2","WF1  2","Total",7092,3489,3603,7045,47,71,296.06,24.0
"2011","WF1  3","WF1  3","Total",8823,4504,4319,8574,249,109,351.55,25.1
"2011","WF1  4","WF1  4","Total",10213,5095,5118,10162,51,67,241.69,42.3
"2011","WF1  5","WF1  5","Total",6617,3370,3247,6586,31,32,1024.63,6.5
"2011","WF10 1","WF10 1","Total",2527,1262,1265,2527,0,11,140.88,17.9
"2011","WF10 2","WF10 2","Total",8967,4355,4612,8819,148,49,1666.90,5.4
"2011","WF10 3","WF10 3","Total",12553,6142,6411,12545,8,99,417.08,30.1
"2011","WF10 4","WF10 4","Total",10919,5334,5585,10831,88,78,388.64,28.1
"2011","WF10 5","WF10 5","Total",10491,5198,5293,10318,173,75,810.49,12.9
"2011","WF11 0","WF11 0","Total",5997,2920,3077,5980,17,32,1106.57,5.4
"2011","WF11 8","WF11 8","Total",6439,3179,3260,6396,43,24,534.47,12.0
"2011","WF11 9","WF11 9","Total",4548,2232,2316,4485,63,32,2472.21,1.8
"2011","WF12 0","WF12 0","Total",9577,4672,4905,9534,43,83,1049.59,9.1
"2011","WF12 7","WF12 7","Total",8101,3951,4150,8024,77,61,487.92,16.6
"2011","WF12 8","WF12 8","Total",6510,3188,3322,6510,0,24,213.30,30.5
"2011","WF12 9","WF12 9","Total",9788,4997,4791,9590,198,61,381.00,25.7
"2011","WF13 1","WF13 1","Total",1486,772,714,1486,0,5,77.49,19.2
"2011","WF13 2","WF13 2","Total",6386,3272,3114,6170,216,57,153.74,41.5
"2011","WF13 3","WF13 3","Total",11450,5713,5737,11410,40,41,273.01,41.9
"2011","WF13 4","WF13 4","Total",8140,4025,4115,8077,63,46,194.54,41.8
"2011","WF14 0","WF14 0","Total",7146,3439,3707,7075,71,71,387.53,18.4
"2011","WF14 8","WF14 8","Total",3909,1948,1961,3835,74,49,689.46,5.7
"2011","WF14 9","WF14 9","Total",8508,4071,4437,8462,46,102,276.10,30.8
"2011","WF15 6","WF15 6","Total",5161,2511,2650,5102,59,40,187.39,27.5
"2011","WF15 7","WF15 7","Total",7511,3731,3780,7509,2,59,355.29,21.1
"2011","WF15 8","WF15 8","Total",5025,2432,2593,4980,45,41,635.57,7.9
"2011","WF16 0","WF16 0","Total",4858,2403,2455,4800,58,26,127.59,38.1
"2011","WF16 9","WF16 9","Total",7765,3813,3952,7696,69,36,183.97,42.2
"2011","WF17 0","WF17 0","Total",8058,4008,4050,7982,76,73,474.25,17.0
"2011","WF17 5","WF17 5","Total",3378,1738,1640,3376,2,11,92.98,36.3
"2011","WF17 6","WF17 6","Total",7082,3555,3527,7020,62,32,298.23,23.7
"2011","WF17 7","WF17 7","Total",13043,6532,6511,12997,46,62,183.93,70.9
"2011","WF17 8","WF17 8","Total",6354,3146,3208,6354,0,34,171.94,37.0
"2011","WF17 9","WF17 9","Total",5804,2785,3019,5758,46,45,341.39,17.0
"2011","WF2  0","WF2  0","Total",11326,5487,5839,11205,121,140,738.07,15.3
"2011","WF2  6","WF2  6","Total",8118,3915,4203,8076,42,185,1078.30,7.5
"2011","WF2  7","WF2  7","Total",8093,3957,4136,8044,49,67,558.98,14.5
"2011","WF2  8","WF2  8","Total",13722,6605,7117,13665,57,90,520.75,26.4
"2011","WF2  9","WF2  9","Total",9764,5180,4584,8961,803,76,318.87,30.6
"2011","WF3  1","WF3  1","Total",11377,5549,5828,11367,10,126,1064.16,10.7
"2011","WF3  2","WF3  2","Total",5161,2537,2624,5118,43,42,418.66,12.3
"2011","WF3  3","WF3  3","Total",8734,4234,4500,8532,202,89,1574.18,5.5
"2011","WF3  4","WF3  4","Total",7322,3582,3740,7317,5,73,1032.40,7.1
"2011","WF4  1","WF4  1","Total",8746,4304,4442,8746,0,82,2551.03,3.4
"2011","WF4  2","WF4  2","Total",6497,3194,3303,6470,27,56,2128.52,3.1
"2011","WF4  3","WF4  3","Total",9232,4504,4728,9154,78,101,1028.03,9.0
"2011","WF4  4","WF4  4","Total",8916,4205,4711,8601,315,105,3057.82,2.9
"2011","WF4  5","WF4  5","Total",5122,2483,2639,5060,62,43,309.72,16.5
"2011","WF4  6","WF4  6","Total",4795,2253,2542,4785,10,38,148.68,32.3
"2011","WF5  0","WF5  0","Total",8703,4270,4433,8685,18,75,364.50,23.9
"2011","WF5  8","WF5  8","Total",6062,2951,3111,6061,1,65,503.80,12.0
"2011","WF5  9","WF5  9","Total",6466,3148,3318,6403,63,59,554.21,11.7
"2011","WF6  1","WF6  1","Total",11465,5626,5839,11395,70,74,438.22,26.2
"2011","WF6  2","WF6  2","Total",9852,4852,5000,9766,86,93,828.88,11.9
"2011","WF7  5","WF7  5","Total",6880,3334,3546,6868,12,25,529.25,13.0
"2011","WF7  6","WF7  6","Total",6403,3066,3337,6275,128,41,916.97,7.0
"2011","WF7  7","WF7  7","Total",6902,3363,3539,6806,96,92,673.82,10.2
"2011","WF8  1","WF8  1","Total",4512,2246,2266,4429,83,31,239.49,18.8
"2011","WF8  2","WF8  2","Total",14548,7016,7532,14449,99,121,520.77,27.9
"2011","WF8  3","WF8  3","Total",5944,2907,3037,5912,32,94,3681.82,1.6
"2011","WF8  4","WF8  4","Total",7372,3633,3739,7362,10,100,726.64,10.1
"2011","WF9  1","WF9  1","Total",6813,3385,3428,6799,14,76,1987.11,3.4
"2011","WF9  2","WF9  2","Total",10366,5116,5250,10296,70,72,761.15,13.6
"2011","WF9  3","WF9  3","Total",8533,4201,4332,8469,64,45,863.04,9.9
"2011","WF9  4","WF9  4","Total",8985,4401,4584,8962,23,46,741.99,12.1
"2011","WF9  5","WF9  5","Total",4548,2229,2319,4438,110,18,941.83,4.8
"2011","WN1  1","WN1  1","Total",436,255,181,434,2,0,46.53,9.4
"2011","WN1  2","WN1  2","Total",9764,4849,4915,9649,115,161,1003.42,9.7
"2011","WN1  3","WN1  3","Total",9839,5006,4833,9751,88,46,199.35,49.4
"2011","WN2  1","WN2  1","Total",8437,4219,4218,8416,21,94,1103.93,7.6
"2011","WN2  2","WN2  2","Total",8153,4021,4132,8113,40,51,523.19,15.6
"2011","WN2  3","WN2  3","Total",9336,4620,4716,9197,139,55,429.94,21.7
"2011","WN2  4","WN2  4","Total",15466,7623,7843,15398,68,104,652.62,23.7
"2011","WN2  5","WN2  5","Total",11380,5809,5571,11088,292,41,1292.17,8.8
"2011","WN3  4","WN3  4","Total",5558,2833,2725,5558,0,24,385.15,14.4
"2011","WN3  5","WN3  5","Total",11699,5805,5894,11662,37,80,455.38,25.7
"2011","WN3  6","WN3  6","Total",12669,6275,6394,12626,43,97,668.84,18.9
"2011","WN4  0","WN4  0","Total",9828,4870,4958,9816,12,74,1349.00,7.3
"2011","WN4  8","WN4  8","Total",8906,4452,4454,8816,90,94,365.52,24.4
"2011","WN4  9","WN4  9","Total",10028,4991,5037,9966,62,100,277.87,36.1
"2011","WN5  0","WN5  0","Total",8414,4219,4195,8348,66,26,508.91,16.5
"2011","WN5  7","WN5  7","Total",11164,5563,5601,11091,73,134,1176.64,9.5
"2011","WN5  8","WN5  8","Total",11161,5491,5670,11115,46,100,434.66,25.7
"2011","WN5  9","WN5  9","Total",13042,6411,6631,12858,184,54,300.97,43.3
"2011","WN6  0","WN6  0","Total",13250,6502,6748,13166,84,223,997.86,13.3
"2011","WN6  7","WN6  7","Total",9501,4762,4739,9429,72,65,164.69,57.7
"2011","WN6  8","WN6  8","Total",11968,5888,6080,11968,0,106,729.41,16.4
"2011","WN6  9","WN6  9","Total",5133,2521,2612,5099,34,67,1498.33,3.4
"2011","WN7  1","WN7  1","Total",9084,4513,4571,9063,21,75,210.91,43.1
"2011","WN7  2","WN7  2","Total",10026,4974,5052,9811,215,76,381.62,26.3
"2011","WN7  3","WN7  3","Total",10142,4923,5219,10142,0,124,595.33,17.0
"2011","WN7  4","WN7  4","Total",7214,3608,3606,7181,33,40,161.38,44.7
"2011","WN7  5","WN7  5","Total",10916,5415,5501,10839,77,77,398.60,27.4
"2011","WN8  0","WN8  0","Total",6195,2968,3227,6119,76,64,848.41,7.3
"2011","WN8  6","WN8  6","Total",16697,8194,8503,16565,132,144,657.97,25.4
"2011","WN8  7","WN8  7","Total",4287,2063,2224,4210,77,84,1643.55,2.6
"2011","WN8  8","WN8  8","Total",10296,5036,5260,10195,101,77,776.02,13.3
"2011","WN8  9","WN8  9","Total",8494,4112,4382,8477,17,47,805.23,10.5
"2011","WR1  1","WR1  1","Total",3814,1914,1900,3687,127,37,58.58,65.1
"2011","WR1  2","WR1  2","Total",1720,921,799,1662,58,23,57.47,29.9
"2011","WR1  3","WR1  3","Total",3421,1773,1648,3258,163,53,132.74,25.8
"2011","WR10 1","WR10 1","Total",6873,3340,3533,6809,64,71,880.53,7.8
"2011","WR10 2","WR10 2","Total",6009,2946,3063,5954,55,113,4608.98,1.3
"2011","WR10 3","WR10 3","Total",4844,2363,2481,4736,108,99,5808.91,0.8
"2011","WR11 1","WR11 1","Total",6851,3373,3478,6796,55,87,309.01,22.2
"2011","WR11 2","WR11 2","Total",6752,3296,3456,6742,10,74,1584.79,4.3
"2011","WR11 3","WR11 3","Total",4079,2018,2061,4051,28,49,262.46,15.5
"2011","WR11 4","WR11 4","Total",7947,3955,3992,7886,61,89,3849.74,2.1
"2011","WR11 7","WR11 7","Total",8478,4179,4299,8417,61,167,5969.22,1.4
"2011","WR11 8","WR11 8","Total",7507,3827,3680,7010,497,104,3597.26,2.1
"2011","WR12 7","WR12 7","Total",5436,2568,2868,5371,65,103,5990.21,0.9
"2011","WR13 5","WR13 5","Total",3508,1736,1772,3469,39,89,4991.51,0.7
"2011","WR13 6","WR13 6","Total",4687,2237,2450,4497,190,137,5337.23,0.9
"2011","WR14 1","WR14 1","Total",11656,5625,6031,11566,90,150,946.54,12.3
"2011","WR14 2","WR14 2","Total",10989,5273,5716,10880,109,150,435.31,25.2
"2011","WR14 3","WR14 3","Total",6198,2883,3315,5325,873,115,523.44,11.8
"2011","WR14 4","WR14 4","Total",5364,2752,2612,5109,255,131,1397.61,3.8
"2011","WR15 8","WR15 8","Total",7098,3503,3595,6962,136,120,10371.61,0.7
"2011","WR2  4","WR2  4","Total",9780,4784,4996,9658,122,165,2487.87,3.9
"2011","WR2  5","WR2  5","Total",11664,5735,5929,11505,159,122,782.81,14.9
"2011","WR2  6","WR2  6","Total",8455,4091,4364,7628,827,156,2689.31,3.1
"2011","WR3  7","WR3  7","Total",11148,5462,5686,10996,152,163,1048.78,10.6
"2011","WR3  8","WR3  8","Total",9324,4596,4728,9297,27,124,1068.08,8.7
"2011","WR4  0","WR4  0","Total",10551,5178,5373,10551,0,123,449.38,23.5
"2011","WR4  9","WR4  9","Total",15485,7597,7888,15432,53,73,382.22,40.5
"2011","WR5  1","WR5  1","Total",10223,5063,5160,10048,175,81,307.41,33.3
"2011","WR5  2","WR5  2","Total",8397,4071,4326,8241,156,119,1344.93,6.2
"2011","WR5  3","WR5  3","Total",12534,6074,6460,12469,65,196,1643.37,7.6
"2011","WR6  5","WR6  5","Total",5057,2531,2526,5045,12,137,10831.34,0.5
"2011","WR6  6","WR6  6","Total",7034,3510,3524,6921,113,151,13803.37,0.5
"2011","WR7  4","WR7  4","Total",4984,2466,2518,4946,38,118,6335.28,0.8
"2011","WR8  0","WR8  0","Total",5707,2723,2984,5553,154,85,4741.51,1.2
"2011","WR8  9","WR8  9","Total",2812,1385,1427,2716,96,93,6673.36,0.4
"2011","WR9  0","WR9  0","Total",5528,2711,2817,5474,54,97,7236.89,0.8
"2011","WR9  7","WR9  7","Total",9794,4829,4965,9715,79,192,5393.93,1.8
"2011","WR9  8","WR9  8","Total",11313,5411,5902,11164,149,124,385.45,29.4
"2011","WR9  9","WR9  9","Total",4393,2118,2275,4355,38,34,154.54,28.4
"2011","WS1  1","WS1  1","Total",413,245,168,413,0,0,34.17,12.1
"2011","WS1  2","WS1  2","Total",7859,3925,3934,7783,76,77,179.46,43.8
"2011","WS1  3","WS1  3","Total",8977,4543,4434,8522,455,107,190.36,47.2
"2011","WS1  4","WS1  4","Total",10022,5039,4983,9986,36,58,173.63,57.7
"2011","WS10 0","WS10 0","Total",14197,6838,7359,14197,0,63,343.14,41.4
"2011","WS10 7","WS10 7","Total",5930,2870,3060,5833,97,40,263.95,22.5
"2011","WS10 8","WS10 8","Total",12757,6344,6413,12662,95,50,356.62,35.8
"2011","WS10 9","WS10 9","Total",13827,6839,6988,13673,154,79,308.37,44.8
"2011","WS11 0","WS11 0","Total",4269,2085,2184,4186,83,20,218.48,19.5
"2011","WS11 1","WS11 1","Total",8801,4289,4512,8798,3,84,1079.54,8.2
"2011","WS11 4","WS11 4","Total",4475,2217,2258,4454,21,24,90.89,49.2
"2011","WS11 5","WS11 5","Total",7462,3659,3803,7431,31,44,178.26,41.9
"2011","WS11 6","WS11 6","Total",3927,1930,1997,3927,0,22,130.73,30.0
"2011","WS11 7","WS11 7","Total",4502,2153,2349,4388,114,46,109.33,41.2
"2011","WS11 8","WS11 8","Total",1678,824,854,1675,3,12,79.50,21.1
"2011","WS11 9","WS11 9","Total",7479,3696,3783,7473,6,45,1515.92,4.9
"2011","WS12 0","WS12 0","Total",3360,1683,1677,3322,38,25,694.25,4.8
"2011","WS12 1","WS12 1","Total",4882,2479,2403,4864,18,34,274.19,17.8
"2011","WS12 2","WS12 2","Total",6544,3266,3278,6453,91,67,155.91,42.0
"2011","WS12 3","WS12 3","Total",5043,2515,2528,4994,49,43,170.54,29.6
"2011","WS12 4","WS12 4","Total",15579,7768,7811,15537,42,108,1844.74,8.4
"2011","WS13 6","WS13 6","Total",8824,4311,4513,8630,194,104,283.44,31.1
"2011","WS13 7","WS13 7","Total",10948,5382,5566,10921,27,114,336.88,32.5
"2011","WS13 8","WS13 8","Total",6856,3334,3522,6748,108,126,5204.68,1.3
"2011","WS14 0","WS14 0","Total",4466,2149,2317,4335,131,76,3517.05,1.3
"2011","WS14 9","WS14 9","Total",12639,6599,6040,11976,663,306,1698.88,7.4
"2011","WS15 1","WS15 1","Total",10108,4946,5162,10078,30,72,719.39,14.1
"2011","WS15 2","WS15 2","Total",14776,7311,7465,14593,183,103,1970.73,7.5
"2011","WS15 3","WS15 3","Total",4121,2022,2099,4021,100,102,8643.19,0.5
"2011","WS15 4","WS15 4","Total",7547,3691,3856,7435,112,90,2706.08,2.8
"2011","WS2  0","WS2  0","Total",8580,4030,4550,8529,51,29,228.13,37.6
"2011","WS2  7","WS2  7","Total",8062,3965,4097,7994,68,29,263.03,30.7
"2011","WS2  8","WS2  8","Total",10737,5352,5385,10712,25,64,264.53,40.6
"2011","WS2  9","WS2  9","Total",11375,5644,5731,11294,81,67,334.19,34.0
"2011","WS3  1","WS3  1","Total",12472,6158,6314,12417,55,40,366.33,34.0
"2011","WS3  2","WS3  2","Total",13129,6377,6752,13078,51,50,329.83,39.8
"2011","WS3  3","WS3  3","Total",13625,6625,7000,13411,214,98,436.45,31.2
"2011","WS3  4","WS3  4","Total",8847,4341,4506,8808,39,100,233.09,38.0
"2011","WS3  5","WS3  5","Total",2024,1016,1008,2024,0,14,162.57,12.5
"2011","WS4  1","WS4  1","Total",12266,5964,6302,12183,83,100,495.83,24.7
"2011","WS4  2","WS4  2","Total",4539,2274,2265,4509,30,73,301.58,15.1
"2011","WS5  3","WS5  3","Total",9765,4811,4954,9765,0,165,433.84,22.5
"2011","WS5  4","WS5  4","Total",11702,5569,6133,11636,66,85,314.14,37.3
"2011","WS6  6","WS6  6","Total",9466,4612,4854,9185,281,80,734.15,12.9
"2011","WS6  7","WS6  7","Total",8717,4319,4398,8717,0,86,492.45,17.7
"2011","WS7  0","WS7  0","Total",3850,1893,1957,3792,58,35,850.89,4.5
"2011","WS7  1","WS7  1","Total",5182,2544,2638,5128,54,50,172.72,30.0
"2011","WS7  2","WS7  2","Total",5490,2743,2747,5481,9,52,134.25,40.9
"2011","WS7  3","WS7  3","Total",1507,733,774,1434,73,5,441.94,3.4
"2011","WS7  4","WS7  4","Total",7524,3763,3761,7506,18,57,313.83,24.0
"2011","WS7  9","WS7  9","Total",6314,3175,3139,6245,69,77,676.02,9.3
"2011","WS8  6","WS8  6","Total",6075,3050,3025,5989,86,31,254.36,23.9
"2011","WS8  7","WS8  7","Total",9511,4641,4870,9450,61,42,548.10,17.4
"2011","WS9  0","WS9  0","Total",9388,4578,4810,9324,64,129,1583.65,5.9
"2011","WS9  8","WS9  8","Total",8659,4129,4530,8652,7,107,496.74,17.4
"2011","WS9  9","WS9  9","Total",8613,4292,4321,8545,68,89,1449.09,5.9
"2011","WV1  1","WV1  1","Total",2472,1401,1071,1017,1455,71,83.46,29.6
"2011","WV1  2","WV1  2","Total",9646,4766,4880,9586,60,49,295.29,32.7
"2011","WV1  3","WV1  3","Total",712,393,319,712,0,0,39.12,18.2
"2011","WV1  4","WV1  4","Total",3709,2111,1598,3642,67,27,71.28,52.0
"2011","WV10 0","WV10 0","Total",11309,5761,5548,11309,0,85,266.95,42.4
"2011","WV10 6","WV10 6","Total",11675,5612,6063,11628,47,85,434.22,26.9
"2011","WV10 7","WV10 7","Total",7013,3821,3192,6197,816,63,2554.59,2.7
"2011","WV10 8","WV10 8","Total",11952,5729,6223,11881,71,71,419.83,28.5
"2011","WV10 9","WV10 9","Total",14445,6852,7593,14332,113,63,330.11,43.8
"2011","WV11 1","WV11 1","Total",11937,5880,6057,11786,151,78,280.89,42.5
"2011","WV11 2","WV11 2","Total",10838,5337,5501,10811,27,80,1246.21,8.7
"2011","WV11 3","WV11 3","Total",11796,5857,5939,11738,58,61,391.93,30.1
"2011","WV12 4","WV12 4","Total",10413,5130,5283,10413,0,57,295.10,35.3
"2011","WV12 5","WV12 5","Total",15236,7470,7766,15182,54,99,345.90,44.0
"2011","WV13 1","WV13 1","Total",5808,2810,2998,5774,34,26,125.26,46.4
"2011","WV13 2","WV13 2","Total",7124,3539,3585,7064,60,37,262.38,27.2
"2011","WV13 3","WV13 3","Total",7706,3766,3940,7706,0,40,185.53,41.5
"2011","WV14 0","WV14 0","Total",5950,2985,2965,5868,82,29,312.73,19.0
"2011","WV14 6","WV14 6","Total",8637,4267,4370,8582,55,39,199.30,43.3
"2011","WV14 7","WV14 7","Total",4361,2126,2235,4361,0,21,136.05,32.1
"2011","WV14 8","WV14 8","Total",14386,7020,7366,14369,17,55,356.09,40.4
"2011","WV14 9","WV14 9","Total",13835,6751,7084,13704,131,90,366.64,37.7
"2011","WV15 5","WV15 5","Total",3753,1864,1889,3665,88,66,3133.98,1.2
"2011","WV15 6","WV15 6","Total",4186,2077,2109,4089,97,66,4232.66,1.0
"2011","WV16 4","WV16 4","Total",7112,3500,3612,7043,69,121,3280.70,2.2
"2011","WV16 5","WV16 5","Total",3360,1633,1727,3315,45,60,1204.77,2.8
"2011","WV16 6","WV16 6","Total",6818,3356,3462,6732,86,95,14251.23,0.5
"2011","WV2  1","WV2  1","Total",3155,1626,1529,3134,21,43,76.60,41.2
"2011","WV2  2","WV2  2","Total",5077,2506,2571,5068,9,29,143.56,35.4
"2011","WV2  3","WV2  3","Total",4166,2061,2105,4025,141,19,75.19,55.4
"2011","WV2  4","WV2  4","Total",2322,1225,1097,2125,197,18,78.33,29.6
"2011","WV3  0","WV3  0","Total",7321,3699,3622,7171,150,47,156.04,46.9
"2011","WV3  7","WV3  7","Total",6814,3276,3538,6758,56,70,129.95,52.4
"2011","WV3  8","WV3  8","Total",6739,3281,3458,6739,0,105,238.03,28.3
"2011","WV3  9","WV3  9","Total",8097,4176,3921,7774,323,111,258.26,31.4
"2011","WV4  4","WV4  4","Total",13379,6557,6822,13217,162,157,969.45,13.8
"2011","WV4  5","WV4  5","Total",11377,5618,5759,11165,212,161,647.78,17.6
"2011","WV4  6","WV4  6","Total",10366,5059,5307,10341,25,76,259.45,40.0
"2011","WV5  0","WV5  0","Total",5714,2750,2964,5695,19,54,318.58,17.9
"2011","WV5  7","WV5  7","Total",2770,1374,1396,2729,41,59,4704.02,0.6
"2011","WV5  8","WV5  8","Total",4103,2070,2033,4103,0,72,201.34,20.4
"2011","WV5  9","WV5  9","Total",3296,1589,1707,3296,0,37,298.85,11.0
"2011","WV6  0","WV6  0","Total",13383,6883,6500,13248,135,117,312.43,42.8
"2011","WV6  7","WV6  7","Total",13382,6551,6831,13327,55,229,5081.66,2.6
"2011","WV6  8","WV6  8","Total",10779,5225,5554,10563,216,186,465.12,23.2
"2011","WV6  9","WV6  9","Total",7451,3656,3795,7369,82,87,287.19,25.9
"2011","WV7  3","WV7  3","Total",7166,3792,3374,6408,758,109,3659.64,2.0
"2011","WV8  1","WV8  1","Total",11192,5325,5867,11141,51,117,727.06,15.4
"2011","WV8  2","WV8  2","Total",4388,2115,2273,4266,122,88,779.63,5.6
"2011","WV9  5","WV9  5","Total",7231,3570,3661,7202,29,87,1442.25,5.0
"2011","YO1  6","YO1  6","Total",1977,1032,945,1962,15,17,38.88,50.8
"2011","YO1  7","YO1  7","Total",731,357,374,721,10,3,17.33,42.2
"2011","YO1  9","YO1  9","Total",1806,903,903,1387,419,14,67.67,26.7
"2011","YO10 3","YO10 3","Total",12864,6429,6435,12784,80,108,391.23,32.9
"2011","YO10 4","YO10 4","Total",9027,4576,4451,8544,483,123,311.08,29.0
"2011","YO10 5","YO10 5","Total",8602,4063,4539,4675,3927,107,1344.04,6.4
"2011","YO11 1","YO11 1","Total",3970,2021,1949,3867,103,20,85.48,46.4
"2011","YO11 2","YO11 2","Total",7468,3674,3794,6786,682,75,281.35,26.5
"2011","YO11 3","YO11 3","Total",11461,5503,5958,11222,239,99,4381.84,2.6
"2011","YO12 4","YO12 4","Total",9023,4417,4606,8867,156,109,5639.85,1.6
"2011","YO12 5","YO12 5","Total",9707,4592,5115,9555,152,139,555.08,17.5
"2011","YO12 6","YO12 6","Total",10678,5065,5613,10564,114,124,320.97,33.3
"2011","YO12 7","YO12 7","Total",11436,5600,5836,11170,266,129,158.41,72.2
"2011","YO13 0","YO13 0","Total",5166,2482,2684,5113,53,103,12066.68,0.4
"2011","YO13 9","YO13 9","Total",4945,2343,2602,4917,28,108,10578.00,0.5
"2011","YO14 0","YO14 0","Total",5499,2600,2899,5497,2,59,3424.69,1.6
"2011","YO14 9","YO14 9","Total",5757,2750,3007,5754,3,54,2632.81,2.2
"2011","YO15 1","YO15 1","Total",3416,1654,1762,3400,16,40,3330.41,1.0
"2011","YO15 2","YO15 2","Total",4695,2395,2300,4337,358,36,81.55,57.6
"2011","YO15 3","YO15 3","Total",5628,2728,2900,5330,298,58,240.50,23.4
"2011","YO16 4","YO16 4","Total",9530,4549,4981,9357,173,58,4650.29,2.0
"2011","YO16 6","YO16 6","Total",7536,3584,3952,7481,55,68,639.44,11.8
"2011","YO16 7","YO16 7","Total",8409,4001,4408,8351,58,67,485.77,17.3
"2011","YO17 6","YO17 6","Total",2783,1379,1404,2761,22,55,8667.12,0.3
"2011","YO17 7","YO17 7","Total",4888,2412,2476,4781,107,72,1625.08,3.0
"2011","YO17 8","YO17 8","Total",5763,2843,2920,5704,59,78,20154.26,0.3
"2011","YO17 9","YO17 9","Total",7780,3825,3955,7716,64,77,11485.79,0.7
"2011","YO18 7","YO18 7","Total",5451,2533,2918,5350,101,91,13935.94,0.4
"2011","YO18 8","YO18 8","Total",5309,2563,2746,5265,44,75,12852.82,0.4
"2011","YO19 4","YO19 4","Total",1464,715,749,1447,17,20,1551.16,0.9
"2011","YO19 5","YO19 5","Total",4410,2123,2287,4356,54,90,2317.42,1.9
"2011","YO19 6","YO19 6","Total",7040,3319,3721,6730,310,137,8462.78,0.8
"2011","YO21 1","YO21 1","Total",5938,2855,3083,5893,45,82,7310.82,0.8
"2011","YO21 2","YO21 2","Total",3079,1530,1549,3066,13,77,19402.30,0.2
"2011","YO21 3","YO21 3","Total",5115,2456,2659,4854,261,52,2135.96,2.4
"2011","YO22 4","YO22 4","Total",5852,2912,2940,5634,218,78,6972.11,0.8
"2011","YO22 5","YO22 5","Total",2876,1367,1509,2852,24,42,8417.89,0.3
"2011","YO23 1","YO23 1","Total",8253,4018,4235,8222,31,88,313.27,26.3
"2011","YO23 2","YO23 2","Total",3906,1878,2028,3895,11,87,1152.83,3.4
"2011","YO23 3","YO23 3","Total",6069,2919,3150,5758,311,154,3683.94,1.6
"2011","YO23 7","YO23 7","Total",1096,546,550,1096,0,26,2746.22,0.4
"2011","YO24 1","YO24 1","Total",5533,2652,2881,5371,162,91,226.94,24.4
"2011","YO24 2","YO24 2","Total",7515,3654,3861,7514,1,95,260.55,28.8
"2011","YO24 3","YO24 3","Total",8686,4145,4541,8614,72,64,170.56,50.9
"2011","YO24 4","YO24 4","Total",7922,3901,4021,7778,144,91,168.17,47.1
"2011","YO25 3","YO25 3","Total",2436,1208,1228,2420,16,42,16277.49,0.1
"2011","YO25 4","YO25 4","Total",4730,2286,2444,4716,14,60,12781.07,0.4
"2011","YO25 5","YO25 5","Total",7013,3341,3672,6857,156,103,769.52,9.1
"2011","YO25 6","YO25 6","Total",6067,2940,3127,6016,51,64,230.25,26.3
"2011","YO25 8","YO25 8","Total",5950,2984,2966,5926,24,85,15669.60,0.4
"2011","YO25 9","YO25 9","Total",7114,3471,3643,7064,50,144,19079.20,0.4
"2011","YO26 4","YO26 4","Total",6090,2992,3098,6090,0,52,141.83,42.9
"2011","YO26 5","YO26 5","Total",11758,5786,5972,11657,101,106,254.16,46.3
"2011","YO26 6","YO26 6","Total",5445,2570,2875,5424,21,118,1253.31,4.3
"2011","YO26 7","YO26 7","Total",2092,1038,1054,2092,0,47,3017.75,0.7
"2011","YO26 8","YO26 8","Total",2938,1445,1493,2843,95,66,4641.53,0.6
"2011","YO26 9","YO26 9","Total",1879,940,939,1300,579,74,3359.56,0.6
"2011","YO30 1","YO30 1","Total",2421,1180,1241,2375,46,57,2775.67,0.9
"2011","YO30 2","YO30 2","Total",1800,966,834,1635,165,25,1639.48,1.1
"2011","YO30 4","YO30 4","Total",2846,1397,1449,2846,0,50,294.63,9.7
"2011","YO30 5","YO30 5","Total",7543,3660,3883,7408,135,92,369.72,20.4
"2011","YO30 6","YO30 6","Total",9602,4702,4900,9414,188,105,185.24,51.8
"2011","YO30 7","YO30 7","Total",2399,1227,1172,2247,152,43,68.27,35.1
"2011","YO31 0","YO31 0","Total",6592,3266,3326,6575,17,61,138.74,47.5
"2011","YO31 1","YO31 1","Total",4632,2244,2388,4621,11,74,406.86,11.4
"2011","YO31 7","YO31 7","Total",5294,2712,2582,5021,273,61,93.98,56.3
"2011","YO31 8","YO31 8","Total",7104,3320,3784,6598,506,69,119.26,59.6
"2011","YO31 9","YO31 9","Total",6617,3187,3430,6610,7,77,145.75,45.4
"2011","YO32 2","YO32 2","Total",5195,2384,2811,5097,98,84,792.56,6.6
"2011","YO32 3","YO32 3","Total",6843,3240,3603,6786,57,123,862.03,7.9
"2011","YO32 4","YO32 4","Total",2737,1205,1532,2667,70,17,317.20,8.6
"2011","YO32 5","YO32 5","Total",6047,2928,3119,5896,151,140,1609.34,3.8
"2011","YO32 9","YO32 9","Total",7448,3602,3846,7374,74,119,2429.70,3.1
"2011","YO41 1","YO41 1","Total",6011,3199,2812,5331,680,101,7356.06,0.8
"2011","YO41 4","YO41 4","Total",2148,1053,1095,2148,0,48,3142.84,0.7
"2011","YO41 5","YO41 5","Total",2678,1320,1358,2660,18,44,3033.09,0.9
"2011","YO42 1","YO42 1","Total",2093,1036,1057,2077,16,50,13959.73,0.1
"2011","YO42 2","YO42 2","Total",8337,4011,4326,8161,176,134,1060.99,7.9
"2011","YO42 4","YO42 4","Total",4129,2067,2062,4116,13,104,10783.21,0.4
"2011","YO43 3","YO43 3","Total",7358,3569,3789,7300,58,88,5920.97,1.2
"2011","YO43 4","YO43 4","Total",4930,2426,2504,4891,39,63,10892.90,0.5
"2011","YO51 9","YO51 9","Total",5533,2688,2845,5435,98,94,4480.50,1.2
"2011","YO60 6","YO60 6","Total",1636,785,851,1628,8,47,5270.93,0.3
"2011","YO60 7","YO60 7","Total",3105,1543,1562,3105,0,80,10361.99,0.3
"2011","YO61 1","YO61 1","Total",5216,2540,2676,5154,62,143,9817.25,0.5
"2011","YO61 2","YO61 2","Total",1222,639,583,1183,39,33,4364.39,0.3
"2011","YO61 3","YO61 3","Total",5295,2456,2839,5273,22,122,5616.76,0.9
"2011","YO61 4","YO61 4","Total",2271,1116,1155,2237,34,67,11485.62,0.2
"2011","YO62 4","YO62 4","Total",2952,1600,1352,2304,648,97,6871.43,0.4
"2011","YO62 5","YO62 5","Total",2803,1368,1435,2791,12,64,20030.63,0.1
"2011","YO62 6","YO62 6","Total",4444,2156,2288,4430,14,70,10943.26,0.4
"2011","YO62 7","YO62 7","Total",1861,937,924,1833,28,39,13739.59,0.1
"2011","YO7  1","YO7  1","Total",9247,4489,4758,9146,101,117,2423.76,3.8
"2011","YO7  2","YO7  2","Total",2679,1312,1367,2674,5,70,14254.72,0.2
"2011","YO7  3","YO7  3","Total",4591,2495,2096,4068,523,76,6565.09,0.7
"2011","YO7  4","YO7  4","Total",3480,1721,1759,3469,11,73,7578.95,0.5
"2011","YO8  3","YO8  3","Total",4439,2201,2238,4399,40,49,3814.68,1.2
"2011","YO8  4","YO8  4","Total",6998,3420,3578,6886,112,66,329.16,21.3
"2011","YO8  5","YO8  5","Total",6557,3217,3340,6526,31,81,4053.79,1.6
"2011","YO8  6","YO8  6","Total",5096,2541,2555,5096,0,71,8083.27,0.6
"2011","YO8  8","YO8  8","Total",8413,4168,4245,8310,103,88,6484.91,1.3
"2011","YO8  9","YO8  9","Total",12226,5985,6241,12169,57,159,2703.83,4.5
"2011","CF10 1","CF10 1","Total",802,494,308,801,1,3,136.37,5.9
"2011","CF10 2","CF10 2","Total",1727,1054,673,1727,0,17,41.96,41.2
"2011","CF10 3","CF10 3","Total",1962,901,1061,999,963,26,22.56,87.0
"2011","CF10 4","CF10 4","Total",4064,2310,1754,4064,0,15,293.91,13.8
"2011","CF10 5","CF10 5","Total",6061,3231,2830,5873,188,22,218.29,27.8
"2011","CF11 0","CF11 0","Total",2253,1247,1006,2253,0,11,140.06,16.1
"2011","CF11 6","CF11 6","Total",12248,6488,5760,11927,321,65,206.39,59.3
"2011","CF11 7","CF11 7","Total",9896,5043,4853,9848,48,50,101.35,97.6
"2011","CF11 8","CF11 8","Total",3904,1910,1994,3904,0,16,201.57,19.4
"2011","CF11 9","CF11 9","Total",7757,3915,3842,7497,260,80,204.74,37.9
"2011","CF14 0","CF14 0","Total",5349,2636,2713,5349,0,152,878.48,6.1
"2011","CF14 1","CF14 1","Total",10205,4869,5336,9961,244,144,209.80,48.6
"2011","CF14 2","CF14 2","Total",10875,5229,5646,10790,85,114,294.42,36.9
"2011","CF14 3","CF14 3","Total",11994,5643,6351,9156,2838,173,262.55,45.7
"2011","CF14 4","CF14 4","Total",9253,4542,4711,9245,8,134,173.76,53.3
"2011","CF14 5","CF14 5","Total",9547,4562,4985,9367,180,121,252.23,37.9
"2011","CF14 6","CF14 6","Total",9007,4239,4768,9007,0,139,537.67,16.8
"2011","CF14 7","CF14 7","Total",4627,2266,2361,4597,30,83,238.39,19.4
"2011","CF14 9","CF14 9","Total",6999,3334,3665,6999,0,157,156.82,44.6
"2011","CF15 7","CF15 7","Total",5543,2670,2873,5465,78,54,1101.14,5.0
"2011","CF15 8","CF15 8","Total",6417,3142,3275,6379,38,173,466.91,13.7
"2011","CF15 9","CF15 9","Total",5863,2857,3006,5844,19,189,1424.48,4.1
"2011","CF23 5","CF23 5","Total",10199,4933,5266,9419,780,206,219.92,46.4
"2011","CF23 6","CF23 6","Total",10743,5201,5542,9964,779,285,321.17,33.4
"2011","CF23 7","CF23 7","Total",8038,3795,4243,7930,108,79,148.56,54.1
"2011","CF23 8","CF23 8","Total",7353,3524,3829,7353,0,87,516.89,14.2
"2011","CF23 9","CF23 9","Total",10694,5105,5589,10694,0,100,354.08,30.2
"2011","CF24 0","CF24 0","Total",5420,2948,2472,3742,1678,46,58.11,93.3
"2011","CF24 1","CF24 1","Total",5618,2974,2644,5371,247,33,85.92,65.4
"2011","CF24 2","CF24 2","Total",12926,6308,6618,12875,51,75,390.22,33.1
"2011","CF24 3","CF24 3","Total",11490,6272,5218,11319,171,94,98.08,117.1
"2011","CF24 4","CF24 4","Total",20071,10122,9949,18675,1396,162,164.89,121.7
"2011","CF24 5","CF24 5","Total",335,153,182,335,0,1,98.20,3.4
"2011","CF3  0","CF3  0","Total",12208,5669,6539,12128,80,87,476.25,25.6
"2011","CF3  1","CF3  1","Total",4686,2191,2495,4595,91,10,94.26,49.7
"2011","CF3  2","CF3  2","Total",3330,1587,1743,3291,39,51,960.17,3.5
"2011","CF3  3","CF3  3","Total",6885,3240,3645,6835,50,45,300.06,22.9
"2011","CF3  4","CF3  4","Total",5839,2838,3001,5812,27,25,198.03,29.5
"2011","CF3  5","CF3  5","Total",7939,3762,4177,7939,0,45,178.57,44.5
"2011","CF3  6","CF3  6","Total",1336,671,665,1336,0,44,2292.13,0.6
"2011","CF31 1","CF31 1","Total",9200,4520,4680,9136,64,91,304.33,30.2
"2011","CF31 2","CF31 2","Total",11749,5756,5993,11708,41,164,321.41,36.6
"2011","CF31 3","CF31 3","Total",4298,2110,2188,4187,111,102,357.80,12.0
"2011","CF31 4","CF31 4","Total",13438,6529,6909,13290,148,188,796.77,16.9
"2011","CF31 5","CF31 5","Total",6198,3046,3152,6198,0,89,145.98,42.5
"2011","CF32 0","CF32 0","Total",4946,2401,2545,4946,0,98,5682.19,0.9
"2011","CF32 7","CF32 7","Total",6195,3019,3176,6195,0,29,2439.34,2.5
"2011","CF32 8","CF32 8","Total",7784,3869,3915,7784,0,62,3089.87,2.5
"2011","CF32 9","CF32 9","Total",10980,5400,5580,10931,49,82,1563.26,7.0
"2011","CF33 4","CF33 4","Total",7059,3412,3647,6992,67,56,1661.31,4.2
"2011","CF33 6","CF33 6","Total",7405,3665,3740,7391,14,58,323.16,22.9
"2011","CF34 0","CF34 0","Total",10932,5343,5589,10930,2,61,1976.12,5.5
"2011","CF34 9","CF34 9","Total",9680,4782,4898,9679,1,89,2095.78,4.6
"2011","CF35 5","CF35 5","Total",5609,2741,2868,5491,118,82,2833.85,2.0
"2011","CF35 6","CF35 6","Total",10543,5986,4557,9165,1378,90,4162.87,2.5
"2011","CF36 3","CF36 3","Total",9009,4261,4748,8801,208,159,701.17,12.8
"2011","CF36 5","CF36 5","Total",6996,3369,3627,6861,135,99,637.62,11.0
"2011","CF37 1","CF37 1","Total",10318,5393,4925,9471,847,133,983.87,10.5
"2011","CF37 2","CF37 2","Total",5515,2688,2827,5490,25,44,941.71,5.9
"2011","CF37 3","CF37 3","Total",7523,3671,3852,7523,0,71,2164.52,3.5
"2011","CF37 4","CF37 4","Total",6874,3331,3543,6801,73,53,779.39,8.8
"2011","CF37 5","CF37 5","Total",8093,3888,4205,8062,31,41,823.48,9.8
"2011","CF38 1","CF38 1","Total",9923,4833,5090,9863,60,94,1283.48,7.7
"2011","CF38 2","CF38 2","Total",13354,6531,6823,13337,17,130,917.42,14.6
"2011","CF39 0","CF39 0","Total",5521,2697,2824,5428,93,46,558.71,9.9
"2011","CF39 8","CF39 8","Total",15268,7433,7835,15116,152,109,3059.89,5.0
"2011","CF39 9","CF39 9","Total",8137,4002,4135,8105,32,46,582.74,14.0
"2011","CF40 1","CF40 1","Total",9475,4714,4761,9424,51,59,1087.44,8.7
"2011","CF40 2","CF40 2","Total",11113,5411,5702,11011,102,58,1090.55,10.2
"2011","CF41 7","CF41 7","Total",10755,5242,5513,10601,154,67,1278.16,8.4
"2011","CF42 5","CF42 5","Total",6047,2961,3086,5999,48,36,2164.43,2.8
"2011","CF42 6","CF42 6","Total",7374,3592,3782,7261,113,71,1319.51,5.6
"2011","CF43 3","CF43 3","Total",4546,2227,2319,4536,10,20,589.00,7.7
"2011","CF43 4","CF43 4","Total",7338,3592,3746,7300,38,25,1442.62,5.1
"2011","CF44 0","CF44 0","Total",7817,3797,4020,7771,46,66,6367.93,1.2
"2011","CF44 6","CF44 6","Total",9865,4845,5020,9798,67,65,1685.57,5.9
"2011","CF44 7","CF44 7","Total",3662,1748,1914,3616,46,34,138.50,26.4
"2011","CF44 8","CF44 8","Total",9043,4389,4654,8852,191,91,1386.81,6.5
"2011","CF44 9","CF44 9","Total",8824,4285,4539,8813,11,62,11917.75,0.7
"2011","CF45 3","CF45 3","Total",10254,4922,5332,10151,103,61,564.05,18.2
"2011","CF45 4","CF45 4","Total",9299,4543,4756,9261,38,63,1765.92,5.3
"2011","CF46 5","CF46 5","Total",6356,3119,3237,6313,43,77,807.74,7.9
"2011","CF46 6","CF46 6","Total",7924,3890,4034,7858,66,65,2620.09,3.0
"2011","CF47 0","CF47 0","Total",7551,3794,3757,7492,59,68,750.83,10.1
"2011","CF47 8","CF47 8","Total",3215,1598,1617,3160,55,26,176.41,18.2
"2011","CF47 9","CF47 9","Total",11120,5316,5804,11086,34,74,243.35,45.7
"2011","CF48 1","CF48 1","Total",8997,4381,4616,8943,54,83,914.65,9.8
"2011","CF48 2","CF48 2","Total",6207,3016,3191,6160,47,40,3593.79,1.7
"2011","CF48 3","CF48 3","Total",4270,2115,2155,4246,24,22,331.50,12.9
"2011","CF48 4","CF48 4","Total",7809,3825,3984,7668,141,67,2799.56,2.8
"2011","CF5  1","CF5  1","Total",11402,5608,5794,11258,144,130,142.43,80.1
"2011","CF5  2","CF5  2","Total",9826,4708,5118,9384,442,240,288.16,34.1
"2011","CF5  3","CF5  3","Total",12152,5807,6345,12145,7,89,273.38,44.5
"2011","CF5  4","CF5  4","Total",16368,7647,8721,16235,133,86,361.68,45.3
"2011","CF5  5","CF5  5","Total",11368,5388,5980,11270,98,35,331.08,34.3
"2011","CF5  6","CF5  6","Total",4908,2401,2507,4847,61,126,6204.92,0.8
"2011","CF61 1","CF61 1","Total",4798,2291,2507,4459,339,84,1658.63,2.9
"2011","CF61 2","CF61 2","Total",5185,2509,2676,5184,1,70,1634.49,3.2
"2011","CF62 3","CF62 3","Total",6907,3391,3516,6901,6,101,4313.93,1.6
"2011","CF62 4","CF62 4","Total",5133,2905,2228,4413,720,49,1327.93,3.9
"2011","CF62 5","CF62 5","Total",2658,1277,1381,2614,44,21,168.63,15.8
"2011","CF62 6","CF62 6","Total",5802,2771,3031,5730,72,100,232.58,24.9
"2011","CF62 7","CF62 7","Total",7271,3531,3740,7255,16,100,232.31,31.3
"2011","CF62 8","CF62 8","Total",7265,3465,3800,7034,231,56,341.47,21.3
"2011","CF62 9","CF62 9","Total",6410,3010,3400,6403,7,60,196.90,32.6
"2011","CF63 1","CF63 1","Total",9265,4413,4852,9229,36,61,215.28,43.0
"2011","CF63 2","CF63 2","Total",5437,2718,2719,5429,8,33,190.61,28.5
"2011","CF63 3","CF63 3","Total",1404,700,704,1404,0,11,19.99,70.2
"2011","CF63 4","CF63 4","Total",5818,2864,2954,5810,8,31,221.99,26.2
"2011","CF64 1","CF64 1","Total",5355,2758,2597,5317,38,71,112.41,47.6
"2011","CF64 2","CF64 2","Total",8190,3895,4295,8068,122,102,322.43,25.4
"2011","CF64 3","CF64 3","Total",8460,4012,4448,8369,91,165,322.38,26.2
"2011","CF64 4","CF64 4","Total",7799,3722,4077,7751,48,117,1959.82,4.0
"2011","CF64 5","CF64 5","Total",6770,3249,3521,6570,200,154,859.25,7.9
"2011","CF71 7","CF71 7","Total",9049,4457,4592,8986,63,281,10029.36,0.9
"2011","CF72 8","CF72 8","Total",10908,5301,5607,10822,86,129,1946.30,5.6
"2011","CF72 9","CF72 9","Total",14649,7153,7496,14636,13,180,2960.79,4.9
"2011","CF81 8","CF81 8","Total",8258,4066,4192,8199,59,45,375.05,22.0
"2011","CF81 9","CF81 9","Total",8173,4049,4124,8117,56,50,2549.45,3.2
"2011","CF82 6","CF82 6","Total",835,401,434,835,0,12,61.66,13.5
"2011","CF82 7","CF82 7","Total",13377,6569,6808,13282,95,116,1663.32,8.0
"2011","CF82 8","CF82 8","Total",6021,2927,3094,6014,7,38,1031.72,5.8
"2011","CF83 1","CF83 1","Total",12523,6097,6426,12449,74,110,947.97,13.2
"2011","CF83 2","CF83 2","Total",12869,6328,6541,12816,53,133,583.38,22.1
"2011","CF83 3","CF83 3","Total",12293,5994,6299,12290,3,100,1906.05,6.4
"2011","CF83 4","CF83 4","Total",6799,3377,3422,6778,21,54,1331.50,5.1
"2011","CF83 8","CF83 8","Total",10758,5239,5519,10712,46,112,1832.51,5.9
"2011","LD1  5","LD1  5","Total",5517,2683,2834,5434,83,87,16016.35,0.3
"2011","LD1  6","LD1  6","Total",5824,2924,2900,5776,48,107,38417.53,0.2
"2011","LD2  3","LD2  3","Total",5688,2796,2892,5635,53,94,31255.45,0.2
"2011","LD3  0","LD3  0","Total",4255,2090,2165,4168,87,74,15005.72,0.3
"2011","LD3  7","LD3  7","Total",5283,2615,2668,5128,155,111,18895.80,0.3
"2011","LD3  8","LD3  8","Total",4502,2215,2287,4181,321,79,37596.47,0.1
"2011","LD3  9","LD3  9","Total",5201,2465,2736,5200,1,125,13667.68,0.4
"2011","LD4  4","LD4  4","Total",769,377,392,766,3,7,7700.76,0.1
"2011","LD5  4","LD5  4","Total",1106,572,534,1079,27,23,16195.32,0.1
"2011","LD6  5","LD6  5","Total",2681,1297,1384,2594,87,39,21084.20,0.1
"2011","LD7  1","LD7  1","Total",4812,2404,2408,4763,49,70,22438.60,0.2
"2011","LD8  2","LD8  2","Total",4154,2046,2108,4113,41,66,14299.56,0.3
"2011","LL11 1","LL11 1","Total",699,342,357,619,80,6,30.96,22.6
"2011","LL11 2","LL11 2","Total",7581,3815,3766,7280,301,75,265.84,28.5
"2011","LL11 3","LL11 3","Total",7063,3537,3526,7008,55,62,5837.46,1.2
"2011","LL11 4","LL11 4","Total",9276,4598,4678,9018,258,72,683.83,13.6
"2011","LL11 5","LL11 5","Total",6878,3401,3477,6804,74,74,3093.22,2.2
"2011","LL11 6","LL11 6","Total",6840,3370,3470,6805,35,51,371.05,18.4
"2011","LL12 0","LL12 0","Total",8045,4007,4038,7983,62,115,3461.58,2.3
"2011","LL12 7","LL12 7","Total",7428,3556,3872,7418,10,59,214.97,34.6
"2011","LL12 8","LL12 8","Total",7707,3724,3983,7605,102,140,973.32,7.9
"2011","LL12 9","LL12 9","Total",5146,2536,2610,5029,117,67,1512.89,3.4
"2011","LL13 0","LL13 0","Total",7979,3995,3984,7966,13,143,9563.60,0.8
"2011","LL13 7","LL13 7","Total",7956,4157,3799,7771,185,106,288.64,27.6
"2011","LL13 8","LL13 8","Total",8042,4093,3949,7987,55,24,174.75,46.0
"2011","LL13 9","LL13 9","Total",10888,5392,5496,10792,96,119,3520.08,3.1
"2011","LL14 1","LL14 1","Total",4722,2352,2370,4715,7,43,139.77,33.8
"2011","LL14 2","LL14 2","Total",8361,4099,4262,8275,86,71,2379.43,3.5
"2011","LL14 3","LL14 3","Total",7051,3511,3540,6992,59,48,804.19,8.8
"2011","LL14 4","LL14 4","Total",4135,2079,2056,4099,36,37,1709.64,2.4
"2011","LL14 5","LL14 5","Total",5031,2431,2600,5002,29,49,2064.98,2.4
"2011","LL14 6","LL14 6","Total",4124,2030,2094,4095,29,33,1741.46,2.4
"2011","LL15 1","LL15 1","Total",7312,3587,3725,7103,209,155,4568.36,1.6
"2011","LL15 2","LL15 2","Total",3520,1753,1767,3516,4,80,14243.79,0.2
"2011","LL16 3","LL16 3","Total",6694,3346,3348,6470,224,82,313.39,21.4
"2011","LL16 4","LL16 4","Total",4815,2353,2462,4683,132,90,9485.33,0.5
"2011","LL16 5","LL16 5","Total",4339,2241,2098,4287,52,101,18404.03,0.2
"2011","LL17 0","LL17 0","Total",5276,2567,2709,5110,166,91,4830.12,1.1
"2011","LL18 1","LL18 1","Total",3942,2086,1856,3933,9,20,95.57,41.2
"2011","LL18 2","LL18 2","Total",8472,4042,4430,8470,2,68,1318.90,6.4
"2011","LL18 3","LL18 3","Total",4661,2321,2340,4597,64,32,182.58,25.5
"2011","LL18 4","LL18 4","Total",10628,5138,5490,10628,0,117,424.38,25.0
"2011","LL18 5","LL18 5","Total",9760,4731,5029,9680,80,91,3718.83,2.6
"2011","LL18 6","LL18 6","Total",3089,1495,1594,3078,11,59,1123.10,2.8
"2011","LL19 7","LL19 7","Total",7107,3417,3690,7096,11,56,416.43,17.1
"2011","LL19 8","LL19 8","Total",7757,3694,4063,7741,16,61,774.63,10.0
"2011","LL19 9","LL19 9","Total",5060,2447,2613,5002,58,69,720.09,7.0
"2011","LL20 7","LL20 7","Total",4741,2382,2359,4664,77,42,13050.45,0.4
"2011","LL20 8","LL20 8","Total",3576,1781,1795,3482,94,37,4841.87,0.7
"2011","LL21 0","LL21 0","Total",2300,1173,1127,2292,8,39,13442.49,0.2
"2011","LL21 9","LL21 9","Total",3766,1891,1875,3718,48,59,21808.51,0.2
"2011","LL22 7","LL22 7","Total",8104,3829,4275,8007,97,73,496.12,16.3
"2011","LL22 8","LL22 8","Total",5448,2700,2748,5400,48,104,15149.57,0.4
"2011","LL22 9","LL22 9","Total",4148,1970,2178,4045,103,37,3236.08,1.3
"2011","LL23 7","LL23 7","Total",4362,2174,2188,4322,40,67,39263.53,0.1
"2011","LL24 0","LL24 0","Total",1939,1002,937,1876,63,33,27263.18,0.1
"2011","LL25 0","LL25 0","Total",474,240,234,474,0,4,5922.21,0.1
"2011","LL26 0","LL26 0","Total",4577,2219,2358,4512,65,50,7961.60,0.6
"2011","LL27 0","LL27 0","Total",783,392,391,782,1,13,3689.58,0.2
"2011","LL28 4","LL28 4","Total",8157,3697,4460,7763,394,119,327.74,24.9
"2011","LL28 5","LL28 5","Total",6000,2921,3079,5931,69,100,5677.98,1.1
"2011","LL29 6","LL29 6","Total",1943,957,986,1943,0,44,66.85,29.1
"2011","LL29 7","LL29 7","Total",4397,2220,2177,4114,283,86,148.10,29.7
"2011","LL29 8","LL29 8","Total",6315,3095,3220,6116,199,83,808.15,7.8
"2011","LL29 9","LL29 9","Total",7672,3784,3888,7616,56,106,436.62,17.6
"2011","LL30 1","LL30 1","Total",9621,4478,5143,9342,279,88,511.55,18.8
"2011","LL30 2","LL30 2","Total",7386,3588,3798,6869,517,89,657.93,11.2
"2011","LL30 3","LL30 3","Total",4879,2314,2565,4840,39,74,421.71,11.6
"2011","LL31 9","LL31 9","Total",9473,4640,4833,9261,212,122,1144.70,8.3
"2011","LL32 8","LL32 8","Total",6518,3166,3352,6488,30,99,9667.69,0.7
"2011","LL33 0","LL33 0","Total",3877,1920,1957,3753,124,38,4762.27,0.8
"2011","LL34 6","LL34 6","Total",4353,2097,2256,4310,43,43,1526.81,2.9
"2011","LL35 0","LL35 0","Total",878,447,431,871,7,12,1128.22,0.8
"2011","LL36 0","LL36 0","Total",1501,677,824,1446,55,15,151.75,9.9
"2011","LL36 9","LL36 9","Total",3174,1541,1633,3116,58,58,16793.64,0.2
"2011","LL37 2","LL37 2","Total",526,268,258,526,0,12,1206.94,0.4
"2011","LL38 2","LL38 2","Total",721,357,364,717,4,8,288.11,2.5
"2011","LL39 1","LL39 1","Total",310,170,140,292,18,12,3488.20,0.1
"2011","LL40 1","LL40 1","Total",2141,1038,1103,2058,83,39,3325.17,0.6
"2011","LL40 2","LL40 2","Total",1991,1003,988,1956,35,34,19770.14,0.1
"2011","LL41 3","LL41 3","Total",3004,1498,1506,2997,7,24,2864.14,1.0
"2011","LL41 4","LL41 4","Total",3475,1694,1781,3445,30,46,18706.18,0.2
"2011","LL42 1","LL42 1","Total",2522,1237,1285,2470,52,26,1600.34,1.6
"2011","LL43 2","LL43 2","Total",467,219,248,458,9,3,372.52,1.3
"2011","LL44 2","LL44 2","Total",1073,523,550,1057,16,13,4182.85,0.3
"2011","LL45 2","LL45 2","Total",645,316,329,632,13,12,5024.45,0.1
"2011","LL46 2","LL46 2","Total",1900,938,962,1829,71,15,3259.39,0.6
"2011","LL47 6","LL47 6","Total",550,278,272,547,3,9,4396.12,0.1
"2011","LL48 6","LL48 6","Total",2587,1277,1310,2564,23,44,4132.79,0.6
"2011","LL49 9","LL49 9","Total",4651,2283,2368,4547,104,71,5290.03,0.9
"2011","LL51 9","LL51 9","Total",630,329,301,630,0,2,5490.71,0.1
"2011","LL52 0","LL52 0","Total",2652,1253,1399,2583,69,42,2576.57,1.0
"2011","LL53 5","LL53 5","Total",4618,2296,2322,4578,40,70,1967.11,2.3
"2011","LL53 6","LL53 6","Total",5578,2698,2880,5561,17,72,10000.59,0.6
"2011","LL53 7","LL53 7","Total",3475,1729,1746,3451,24,75,7533.57,0.5
"2011","LL53 8","LL53 8","Total",3552,1798,1754,3552,0,61,13319.55,0.3
"2011","LL54 5","LL54 5","Total",3267,1633,1634,3263,4,45,9767.45,0.3
"2011","LL54 6","LL54 6","Total",4135,1967,2168,4112,23,46,4276.26,1.0
"2011","LL54 7","LL54 7","Total",3840,1913,1927,3820,20,85,6577.65,0.6
"2011","LL55 1","LL55 1","Total",5170,2523,2647,5085,85,85,495.79,10.4
"2011","LL55 2","LL55 2","Total",6804,3308,3496,6752,52,80,1208.74,5.6
"2011","LL55 3","LL55 3","Total",3137,1549,1588,3123,14,37,3420.03,0.9
"2011","LL55 4","LL55 4","Total",6582,3221,3361,6479,103,96,15988.86,0.4
"2011","LL56 4","LL56 4","Total",2284,1145,1139,2212,72,33,589.92,3.9
"2011","LL57 1","LL57 1","Total",6111,3000,3111,5737,374,49,192.08,31.8
"2011","LL57 2","LL57 2","Total",9872,4857,5015,7546,2326,203,616.16,16.0
"2011","LL57 3","LL57 3","Total",5624,2764,2860,5601,23,78,4997.92,1.1
"2011","LL57 4","LL57 4","Total",6076,3001,3075,6060,16,61,5600.06,1.1
"2011","LL58 8","LL58 8","Total",3858,1859,1999,3819,39,68,3402.39,1.1
"2011","LL59 5","LL59 5","Total",5630,2733,2897,5591,39,99,2662.79,2.1
"2011","LL60 6","LL60 6","Total",3149,1573,1576,3149,0,48,5429.10,0.6
"2011","LL61 5","LL61 5","Total",3107,1487,1620,2979,128,58,366.53,8.5
"2011","LL61 6","LL61 6","Total",2944,1430,1514,2891,53,34,4749.89,0.6
"2011","LL62 5","LL62 5","Total",1704,823,881,1666,38,27,4088.48,0.4
"2011","LL63 5","LL63 5","Total",1370,682,688,1370,0,18,3923.64,0.3
"2011","LL64 5","LL64 5","Total",1008,489,519,992,16,16,241.82,4.2
"2011","LL65 1","LL65 1","Total",5358,2698,2660,5302,56,35,352.18,15.2
"2011","LL65 2","LL65 2","Total",8301,4058,4243,8223,78,66,3138.88,2.6
"2011","LL65 3","LL65 3","Total",6525,3282,3243,6352,173,51,7524.94,0.9
"2011","LL65 4","LL65 4","Total",3490,1745,1745,3472,18,28,9213.60,0.4
"2011","LL67 0","LL67 0","Total",1357,672,685,1357,0,7,1372.64,1.0
"2011","LL68 0","LL68 0","Total",1293,641,652,1291,2,16,2352.31,0.5
"2011","LL68 9","LL68 9","Total",5092,2525,2567,5036,56,54,4854.35,1.0
"2011","LL69 9","LL69 9","Total",595,303,292,595,0,9,116.20,5.1
"2011","LL70 9","LL70 9","Total",354,172,182,354,0,4,1323.71,0.3
"2011","LL71 7","LL71 7","Total",227,111,116,223,4,0,1511.73,0.2
"2011","LL71 8","LL71 8","Total",1499,770,729,1499,0,16,2796.12,0.5
"2011","LL72 8","LL72 8","Total",710,334,376,710,0,10,66.74,10.6
"2011","LL73 8","LL73 8","Total",254,127,127,254,0,9,1140.81,0.2
"2011","LL74 8","LL74 8","Total",2236,1062,1174,2229,7,26,333.80,6.7
"2011","LL75 8","LL75 8","Total",1491,713,778,1429,62,22,1833.64,0.8
"2011","LL76 8","LL76 8","Total",324,173,151,316,8,6,476.33,0.7
"2011","LL77 7","LL77 7","Total",7366,3558,3808,7333,33,102,7517.65,1.0
"2011","LL78 8","LL78 8","Total",509,254,255,509,0,19,333.84,1.5
"2011","NP10 0","NP10 0","Total",1497,753,744,1497,0,29,77.29,19.4
"2011","NP10 8","NP10 8","Total",12113,5907,6206,12109,4,156,3884.90,3.1
"2011","NP10 9","NP10 9","Total",9591,4686,4905,9537,54,152,808.71,11.9
"2011","NP11 3","NP11 3","Total",4938,2452,2486,4900,38,43,565.30,8.7
"2011","NP11 4","NP11 4","Total",5779,2870,2909,5701,78,52,795.69,7.3
"2011","NP11 5","NP11 5","Total",6609,3297,3312,6578,31,42,1521.04,4.3
"2011","NP11 6","NP11 6","Total",11371,5539,5832,11364,7,80,739.07,15.4
"2011","NP11 7","NP11 7","Total",9099,4455,4644,8986,113,75,2922.23,3.1
"2011","NP12 0","NP12 0","Total",8020,3944,4076,7962,58,50,2046.89,3.9
"2011","NP12 1","NP12 1","Total",8496,4149,4347,8427,69,70,423.05,20.1
"2011","NP12 2","NP12 2","Total",8849,4375,4474,8790,59,60,594.81,14.9
"2011","NP12 3","NP12 3","Total",8159,3966,4193,8114,45,57,335.10,24.3
"2011","NP13 1","NP13 1","Total",8778,4307,4471,8688,90,51,1444.05,6.1
"2011","NP13 2","NP13 2","Total",6241,3146,3095,6241,0,40,1371.63,4.6
"2011","NP13 3","NP13 3","Total",4808,2395,2413,4781,27,33,794.26,6.1
"2011","NP15 1","NP15 1","Total",5410,2875,2535,5007,403,131,8519.82,0.6
"2011","NP15 2","NP15 2","Total",2456,1213,1243,2374,82,45,5351.33,0.5
"2011","NP16 5","NP16 5","Total",11395,5500,5895,11269,126,169,510.23,22.3
"2011","NP16 6","NP16 6","Total",6907,3472,3435,6861,46,204,13158.78,0.5
"2011","NP16 7","NP16 7","Total",5653,2793,2860,5386,267,90,2756.80,2.1
"2011","NP18 1","NP18 1","Total",4796,2306,2490,4688,108,129,2587.53,1.9
"2011","NP18 2","NP18 2","Total",6318,3122,3196,6260,58,86,5292.01,1.2
"2011","NP18 3","NP18 3","Total",6163,3002,3161,5506,657,141,541.39,11.4
"2011","NP19 0","NP19 0","Total",10862,5477,5385,10792,70,59,181.85,59.7
"2011","NP19 4","NP19 4","Total",4917,2387,2530,4917,0,35,309.83,15.9
"2011","NP19 7","NP19 7","Total",12838,6343,6495,12831,7,116,280.55,45.8
"2011","NP19 8","NP19 8","Total",9322,4667,4655,9261,61,61,148.30,62.9
"2011","NP19 9","NP19 9","Total",13684,6499,7185,13621,63,79,355.84,38.5
"2011","NP20 1","NP20 1","Total",692,393,299,688,4,4,35.03,19.8
"2011","NP20 2","NP20 2","Total",7516,3802,3714,7470,46,68,554.87,13.5
"2011","NP20 3","NP20 3","Total",10983,5319,5664,10917,66,89,466.58,23.5
"2011","NP20 4","NP20 4","Total",6510,3273,3237,6268,242,81,148.93,43.7
"2011","NP20 5","NP20 5","Total",9485,4599,4886,9423,62,109,316.38,30.0
"2011","NP20 6","NP20 6","Total",7997,3850,4147,7925,72,66,207.10,38.6
"2011","NP20 7","NP20 7","Total",7606,3644,3962,7556,50,26,513.66,14.8
"2011","NP22 3","NP22 3","Total",7673,3741,3932,7577,96,54,980.23,7.8
"2011","NP22 4","NP22 4","Total",7430,3576,3854,7421,9,64,2187.33,3.4
"2011","NP22 5","NP22 5","Total",6921,3357,3564,6886,35,54,1915.18,3.6
"2011","NP23 4","NP23 4","Total",10165,5023,5142,10031,134,87,1316.97,7.7
"2011","NP23 5","NP23 5","Total",10748,5251,5497,10647,101,80,1164.83,9.2
"2011","NP23 6","NP23 6","Total",8419,4106,4313,8338,81,70,688.71,12.2
"2011","NP23 7","NP23 7","Total",2739,1356,1383,2734,5,23,725.26,3.8
"2011","NP23 8","NP23 8","Total",1434,722,712,1414,20,13,403.80,3.6
"2011","NP24 6","NP24 6","Total",4966,2469,2497,4905,61,23,964.09,5.2
"2011","NP25 3","NP25 3","Total",5329,2597,2732,4998,331,144,2224.54,2.4
"2011","NP25 4","NP25 4","Total",3486,1742,1744,3391,95,87,7667.63,0.5
"2011","NP25 5","NP25 5","Total",6349,3059,3290,6233,116,131,6150.28,1.0
"2011","NP26 3","NP26 3","Total",9305,4596,4709,9288,17,152,5141.32,1.8
"2011","NP26 4","NP26 4","Total",7669,3806,3863,7628,41,92,269.45,28.5
"2011","NP26 5","NP26 5","Total",5547,2762,2785,5505,42,85,2228.21,2.5
"2011","NP4  0","NP4  0","Total",7833,3808,4025,7787,46,85,5374.94,1.5
"2011","NP4  5","NP4  5","Total",9299,4583,4716,9198,101,89,1039.88,8.9
"2011","NP4  6","NP4  6","Total",7191,3509,3682,7104,87,43,1235.82,5.8
"2011","NP4  7","NP4  7","Total",6882,3348,3534,6802,80,47,2268.32,3.0
"2011","NP4  8","NP4  8","Total",8277,4081,4196,8231,46,57,1827.85,4.5
"2011","NP4  9","NP4  9","Total",6055,2978,3077,6026,29,29,1782.98,3.4
"2011","NP44 1","NP44 1","Total",8280,4070,4210,8244,36,70,368.77,22.5
"2011","NP44 2","NP44 2","Total",5440,2594,2846,5440,0,60,225.33,24.1
"2011","NP44 3","NP44 3","Total",7181,3486,3695,7047,134,50,842.90,8.5
"2011","NP44 4","NP44 4","Total",6680,3215,3465,6680,0,42,145.20,46.0
"2011","NP44 5","NP44 5","Total",5788,2794,2994,5758,30,56,717.35,8.1
"2011","NP44 6","NP44 6","Total",5172,2549,2623,5096,76,84,255.11,20.3
"2011","NP44 7","NP44 7","Total",5273,2575,2698,5246,27,50,1107.05,4.8
"2011","NP44 8","NP44 8","Total",3361,1590,1771,3314,47,41,493.77,6.8
"2011","NP7  0","NP7  0","Total",3899,1906,1993,3813,86,74,1825.40,2.1
"2011","NP7  5","NP7  5","Total",4705,2199,2506,4648,57,69,172.25,27.3
"2011","NP7  6","NP7  6","Total",5831,2820,3011,5826,5,51,204.35,28.5
"2011","NP7  7","NP7  7","Total",3030,1459,1571,2927,103,54,7626.13,0.4
"2011","NP7  8","NP7  8","Total",3164,1552,1612,3149,15,68,13681.28,0.2
"2011","NP7  9","NP7  9","Total",5442,2656,2786,5393,49,93,8745.95,0.6
"2011","NP8  1","NP8  1","Total",5547,2719,2828,5481,66,131,19741.69,0.3
"2011","SA1  1","SA1  1","Total",3290,1993,1297,3257,33,28,101.57,32.4
"2011","SA1  2","SA1  2","Total",5442,2738,2704,5396,46,27,169.46,32.1
"2011","SA1  3","SA1  3","Total",3863,2150,1713,3620,243,25,58.36,66.2
"2011","SA1  4","SA1  4","Total",4626,2578,2048,4494,132,35,56.45,81.9
"2011","SA1  5","SA1  5","Total",446,270,176,410,36,4,14.90,29.9
"2011","SA1  6","SA1  6","Total",15499,7906,7593,15360,139,120,281.98,55.0
"2011","SA1  7","SA1  7","Total",6425,3098,3327,6401,24,38,828.07,7.8
"2011","SA1  8","SA1  8","Total",7490,3768,3722,7490,0,32,1026.81,7.3
"2011","SA10 6","SA10 6","Total",9267,4508,4759,9114,153,66,1202.21,7.7
"2011","SA10 7","SA10 7","Total",10133,4914,5219,10050,83,113,1411.68,7.2
"2011","SA10 8","SA10 8","Total",6573,3214,3359,6566,7,87,3560.47,1.8
"2011","SA10 9","SA10 9","Total",3854,1909,1945,3800,54,18,2383.75,1.6
"2011","SA11 1","SA11 1","Total",6143,3082,3061,6103,40,42,151.28,40.6
"2011","SA11 2","SA11 2","Total",10046,4913,5133,10016,30,71,1064.74,9.4
"2011","SA11 3","SA11 3","Total",11479,5533,5946,11241,238,118,1337.85,8.6
"2011","SA11 4","SA11 4","Total",3135,1552,1583,3135,0,19,2974.53,1.1
"2011","SA11 5","SA11 5","Total",5785,2865,2920,5748,37,45,4197.01,1.4
"2011","SA12 6","SA12 6","Total",10613,5174,5439,10499,114,68,295.72,35.9
"2011","SA12 7","SA12 7","Total",8459,4051,4408,8447,12,45,268.30,31.5
"2011","SA12 8","SA12 8","Total",6819,3305,3514,6769,50,65,901.86,7.6
"2011","SA12 9","SA12 9","Total",6767,3295,3472,6732,35,64,3003.86,2.3
"2011","SA13 1","SA13 1","Total",5893,2925,2968,5829,64,42,135.79,43.4
"2011","SA13 2","SA13 2","Total",8487,4199,4288,8484,3,100,7033.71,1.2
"2011","SA13 3","SA13 3","Total",5283,2626,2657,5258,25,22,5595.50,0.9
"2011","SA14 6","SA14 6","Total",6834,3374,3460,6722,112,73,4327.54,1.6
"2011","SA14 7","SA14 7","Total",6239,3033,3206,6210,29,57,3426.08,1.8
"2011","SA14 8","SA14 8","Total",12891,6278,6613,12726,165,151,3103.22,4.2
"2011","SA14 9","SA14 9","Total",7999,3878,4121,7936,63,64,1015.85,7.9
"2011","SA15 1","SA15 1","Total",9615,4742,4873,9477,138,72,279.51,34.4
"2011","SA15 2","SA15 2","Total",8384,4124,4260,8342,42,66,472.53,17.7
"2011","SA15 3","SA15 3","Total",6993,3338,3655,6862,131,72,191.35,36.5
"2011","SA15 4","SA15 4","Total",5367,2608,2759,5289,78,56,1756.00,3.1
"2011","SA15 5","SA15 5","Total",6377,3158,3219,6371,6,78,4362.64,1.5
"2011","SA16 0","SA16 0","Total",8547,4164,4383,8508,39,63,4145.80,2.1
"2011","SA17 4","SA17 4","Total",6168,2991,3177,6144,24,51,3747.10,1.6
"2011","SA17 5","SA17 5","Total",3239,1604,1635,3191,48,31,7651.71,0.4
"2011","SA18 1","SA18 1","Total",9580,4734,4846,9521,59,86,5608.99,1.7
"2011","SA18 2","SA18 2","Total",9000,4371,4629,8902,98,112,4469.88,2.0
"2011","SA18 3","SA18 3","Total",11107,5473,5634,10896,211,143,3883.69,2.9
"2011","SA19 6","SA19 6","Total",2971,1424,1547,2904,67,48,4748.50,0.6
"2011","SA19 7","SA19 7","Total",2686,1348,1338,2656,30,49,12100.45,0.2
"2011","SA19 8","SA19 8","Total",2206,1103,1103,2200,6,33,17509.25,0.1
"2011","SA19 9","SA19 9","Total",1531,771,760,1524,7,39,13815.98,0.1
"2011","SA2  0","SA2  0","Total",13646,7001,6645,13260,386,209,235.38,58.0
"2011","SA2  7","SA2  7","Total",11699,5750,5949,10556,1143,201,1099.93,10.6
"2011","SA2  8","SA2  8","Total",6194,2949,3245,5253,941,107,377.60,16.4
"2011","SA2  9","SA2  9","Total",6847,3370,3477,6619,228,120,275.04,24.9
"2011","SA20 0","SA20 0","Total",3574,1765,1809,3373,201,80,24469.01,0.1
"2011","SA3  1","SA3  1","Total",3159,1569,1590,3122,37,48,9585.71,0.3
"2011","SA3  2","SA3  2","Total",2800,1385,1415,2702,98,54,3035.21,0.9
"2011","SA3  3","SA3  3","Total",3676,1743,1933,3606,70,80,625.10,5.9
"2011","SA3  4","SA3  4","Total",7451,3521,3930,7333,118,132,429.06,17.4
"2011","SA3  5","SA3  5","Total",9149,4358,4791,9088,61,154,712.28,12.8
"2011","SA31 1","SA31 1","Total",5748,2799,2949,5718,30,68,362.28,15.9
"2011","SA31 2","SA31 2","Total",3883,1858,2025,3854,29,83,1660.44,2.3
"2011","SA31 3","SA31 3","Total",7292,3340,3952,6688,604,89,1406.09,5.2
"2011","SA32 7","SA32 7","Total",4066,2028,2038,4045,21,79,21431.95,0.2
"2011","SA32 8","SA32 8","Total",3692,1807,1885,3673,19,81,9872.81,0.4
"2011","SA33 4","SA33 4","Total",5366,2616,2750,5275,91,95,9704.53,0.6
"2011","SA33 5","SA33 5","Total",2920,1439,1481,2912,8,53,9056.87,0.3
"2011","SA33 6","SA33 6","Total",4060,2055,2005,4025,35,69,18849.61,0.2
"2011","SA34 0","SA34 0","Total",5398,2685,2713,5378,20,73,19910.43,0.3
"2011","SA35 0","SA35 0","Total",715,364,351,713,2,6,4247.69,0.2
"2011","SA36 0","SA36 0","Total",395,210,185,395,0,6,676.22,0.6
"2011","SA37 0","SA37 0","Total",1287,649,638,1284,3,18,4159.06,0.3
"2011","SA38 9","SA38 9","Total",4761,2310,2451,4681,80,51,10630.41,0.4
"2011","SA39 9","SA39 9","Total",2321,1168,1153,2298,23,26,6014.38,0.4
"2011","SA4  0","SA4  0","Total",3089,1521,1568,3081,8,46,961.88,3.2
"2011","SA4  3","SA4  3","Total",10430,5031,5399,10391,39,167,3019.51,3.5
"2011","SA4  4","SA4  4","Total",11061,5426,5635,10982,79,97,814.75,13.6
"2011","SA4  6","SA4  6","Total",7363,3613,3750,7363,0,87,381.40,19.3
"2011","SA4  8","SA4  8","Total",6701,3254,3447,6592,109,61,1977.41,3.4
"2011","SA4  9","SA4  9","Total",5712,2768,2944,5698,14,59,2197.96,2.6
"2011","SA40 9","SA40 9","Total",3580,1748,1832,3482,98,31,10924.54,0.3
"2011","SA41 3","SA41 3","Total",1882,971,911,1882,0,39,9091.25,0.2
"2011","SA42 0","SA42 0","Total",2306,1100,1206,2290,16,40,5623.72,0.4
"2011","SA43 1","SA43 1","Total",4705,2264,2441,4667,38,59,3663.81,1.3
"2011","SA43 2","SA43 2","Total",5213,2579,2634,5207,6,72,6589.81,0.8
"2011","SA43 3","SA43 3","Total",2617,1257,1360,2574,43,40,5062.33,0.5
"2011","SA44 4","SA44 4","Total",3862,1899,1963,3817,45,66,9420.48,0.4
"2011","SA44 5","SA44 5","Total",4959,2429,2530,4902,57,66,10335.22,0.5
"2011","SA44 6","SA44 6","Total",2669,1306,1363,2667,2,46,7685.84,0.3
"2011","SA45 9","SA45 9","Total",1730,861,869,1716,14,25,1544.36,1.1
"2011","SA46 0","SA46 0","Total",2732,1305,1427,2703,29,47,2709.58,1.0
"2011","SA47 0","SA47 0","Total",1250,648,602,1249,1,16,3294.15,0.4
"2011","SA48 7","SA48 7","Total",4556,2314,2242,4033,523,85,9056.03,0.5
"2011","SA48 8","SA48 8","Total",4395,2182,2213,4384,11,71,14270.56,0.3
"2011","SA5  4","SA5  4","Total",5523,2657,2866,5398,125,42,793.34,7.0
"2011","SA5  5","SA5  5","Total",8074,3849,4225,8056,18,54,294.26,27.4
"2011","SA5  7","SA5  7","Total",6142,2972,3170,6112,30,37,2214.54,2.8
"2011","SA5  8","SA5  8","Total",8446,4129,4317,8402,44,66,213.13,39.6
"2011","SA5  9","SA5  9","Total",8275,4021,4254,8208,67,63,227.78,36.3
"2011","SA6  5","SA6  5","Total",8925,4318,4607,8881,44,88,1108.83,8.0
"2011","SA6  6","SA6  6","Total",13362,6517,6845,13287,75,127,3361.34,4.0
"2011","SA6  7","SA6  7","Total",7331,3587,3744,7265,66,51,233.48,31.4
"2011","SA6  8","SA6  8","Total",4564,2283,2281,4506,58,20,184.50,24.7
"2011","SA61 1","SA61 1","Total",8041,3852,4189,8005,36,98,1041.54,7.7
"2011","SA61 2","SA61 2","Total",6221,2980,3241,6144,77,70,389.55,16.0
"2011","SA62 3","SA62 3","Total",5169,2483,2686,4994,175,98,11445.05,0.5
"2011","SA62 4","SA62 4","Total",4481,2198,2283,4467,14,81,9526.63,0.5
"2011","SA62 5","SA62 5","Total",5626,2769,2857,5528,98,105,20243.27,0.3
"2011","SA62 6","SA62 6","Total",6056,3114,2942,5602,454,96,15847.74,0.4
"2011","SA63 4","SA63 4","Total",1112,556,556,1112,0,20,4774.13,0.2
"2011","SA64 0","SA64 0","Total",2462,1229,1233,2451,11,34,3960.72,0.6
"2011","SA65 9","SA65 9","Total",4379,2095,2284,4298,81,54,6117.35,0.7
"2011","SA66 7","SA66 7","Total",3021,1469,1552,3016,5,66,10475.70,0.3
"2011","SA67 7","SA67 7","Total",2316,1088,1228,2293,23,30,1717.98,1.3
"2011","SA67 8","SA67 8","Total",4614,2251,2363,4484,130,81,11770.22,0.4
"2011","SA68 0","SA68 0","Total",4305,2114,2191,4252,53,66,6116.49,0.7
"2011","SA69 9","SA69 9","Total",3534,1755,1779,3447,87,59,915.63,3.9
"2011","SA7  0","SA7  0","Total",2046,1025,1021,2045,1,15,352.12,5.8
"2011","SA7  9","SA7  9","Total",13072,6345,6727,12916,156,103,1265.86,10.3
"2011","SA70 7","SA70 7","Total",3225,1594,1631,3121,104,43,1481.79,2.2
"2011","SA70 8","SA70 8","Total",6506,3095,3411,6332,174,98,5583.26,1.2
"2011","SA71 4","SA71 4","Total",5636,2718,2918,5513,123,68,525.44,10.7
"2011","SA71 5","SA71 5","Total",4636,2285,2351,4626,10,83,11352.30,0.4
"2011","SA72 4","SA72 4","Total",828,409,419,828,0,16,1305.34,0.6
"2011","SA72 6","SA72 6","Total",9753,4841,4912,9672,81,79,631.62,15.4
"2011","SA73 1","SA73 1","Total",8276,4000,4276,8214,62,104,3741.37,2.2
"2011","SA73 2","SA73 2","Total",6832,3395,3437,6803,29,62,242.73,28.1
"2011","SA73 3","SA73 3","Total",5246,2515,2731,5244,2,59,1284.14,4.1
"2011","SA8  3","SA8  3","Total",4769,2344,2425,4736,33,59,2061.58,2.3
"2011","SA8  4","SA8  4","Total",7787,3816,3971,7673,114,76,3174.90,2.5
"2011","SA9  1","SA9  1","Total",7898,3827,4071,7723,175,67,8164.17,1.0
"2011","SA9  2","SA9  2","Total",7281,3595,3686,7253,28,69,3306.61,2.2
